Ticker,Total Trades,Profitable Trades,Losing Trades,Total Profit/Loss,Profit Percentage,Buy Prices,Sell Prices
360ONE,1,1,0,4550,4.55,455.0,521.6500244140625
3MINDIA,7,3,4,3722,3.72,"1028.0, 4107.2001953125, 3310.050048828125, 11957.5, 22488.19921875, 21078.0, 21854.05078125","1244.4000244140625, 3929.89990234375, 3306.10009765625, 11164.7998046875, 22241.75, 20264.44921875, 22742.80078125"
AARTIDRUGS,5,0,5,-8055,-8.05,"19.9375, 8.737500190734863, 12.46875, 132.3249969482422, 134.4875030517578","20.375, 8.181249618530273, 11.800000190734863, 121.82499694824219, 130.0"
AARTIIND,5,2,3,-3062,-3.06,"8.844989776611328, 13.48617935180664, 19.354490280151367, 780.0999755859375, 562.25","8.261802673339844, 12.939441680908203, 20.508712768554688, 830.7000122070312, 512.2999877929688"
AARTIPHARM,0,0,0,0,0.0,,
AAVAS,3,2,1,-920,-0.92,"1339.25, 2385.5, 1536.949951171875","1370.449951171875, 2274.60009765625, 1548.800048828125"
ABB,8,4,4,11143,11.14,"440.4476318359375, 438.9950866699219, 741.0850830078125, 582.0281982421875, 492.46795654296875, 994.83154296875, 1187.84228515625, 941.1500244140625","333.36572265625, 590.9706420898438, 735.3655395507812, 555.92724609375, 571.3154907226562, 1087.7962646484375, 1279.899169921875, 894.9500122070312"
ABBOTINDIA,0,0,0,0,0.0,,
ABCAPITAL,3,1,2,-6635,-6.64,"97.19999694824219, 109.44999694824219, 63.29999923706055","97.75, 102.69999694824219, 54.099998474121094"
ABFRL,5,1,4,-3018,-3.02,"147.90536499023438, 195.6628875732422, 125.30000305175781, 139.89999389648438, 223.14999389648438","155.6924591064453, 180.8772735595703, 124.69999694824219, 133.60000610351562, 219.5500030517578"
ABSLAMC,2,1,1,1246,1.25,"460.0, 356.45001220703125","455.0, 372.3500061035156"
ACC,6,5,1,8550,8.55,"850.8499755859375, 1413.5, 1529.75, 1270.199951171875, 2328.89990234375, 2211.25","934.9500122070312, 1411.5, 1638.75, 1332.25, 2198.39990234375, 2544.300048828125"
ACCELYA,2,1,1,197,0.2,"60.54999923706055, 810.5999755859375","50.599998474121094, 941.0499877929688"
ACE,6,4,2,37056,37.06,"45.79999923706055, 15.699999809265137, 46.849998474121094, 12.149999618530273, 114.5999984741211, 54.45000076293945","53.2599983215332, 33.25, 45.29999923706055, 13.0, 98.80000305175781, 56.349998474121094"
ACI,0,0,0,0,0.0,,
ADANIENSOL,0,0,0,0,0.0,,
ADANIENT,10,6,4,36437,36.44,"32.421504974365234, 63.74709701538086, 30.831275939941406, 31.827564239501953, 50.348873138427734, 47.24293518066406, 41.712188720703125, 145.85000610351562, 156.25, 2493.35009765625","51.72650146484375, 57.43982696533203, 33.00778579711914, 40.33433151245117, 44.89986038208008, 39.69605255126953, 47.48814010620117, 199.64999389648438, 175.25, 2388.050048828125"
ADANIGREEN,2,1,1,-1893,-1.89,"2174.699951171875, 1093.300048828125","2436.199951171875, 928.6500244140625"
ADANIPORTS,11,7,4,12719,12.72,"158.0800018310547, 77.2300033569336, 77.75, 144.4499969482422, 146.25, 247.6999969482422, 232.39999389648438, 365.6499938964844, 413.95001220703125, 323.79998779296875, 631.9000244140625","98.83000183105469, 68.33000183105469, 122.23999786376953, 161.4499969482422, 148.64999389648438, 238.1999969482422, 262.95001220703125, 387.70001220703125, 395.79998779296875, 343.8999938964844, 681.2999877929688"
ADANIPOWER,8,4,4,972,0.97,"52.95000076293945, 51.95000076293945, 31.5, 33.5, 31.350000381469727, 36.400001525878906, 37.25, 224.85000610351562","48.20000076293945, 57.400001525878906, 30.700000762939453, 33.349998474121094, 35.400001525878906, 36.0, 36.900001525878906, 249.64999389648438"
ADFFOODS,2,1,1,-1751,-1.75,"11.989999771118164, 53.90999984741211","11.380000114440918, 53.93000030517578"
ADVENZYMES,2,1,1,-3243,-3.24,"261.6000061035156, 182.60000610351562","220.85000610351562, 190.39999389648438"
AEGISCHEM,4,3,1,24021,24.02,"10.295978546142578, 4.739990234375, 16.610000610351562, 16.03999900817871","10.946977615356445, 7.595983982086182, 16.09000015258789, 16.69499969482422"
AETHER,0,0,0,0,0.0,,
AFFLE,2,0,2,-1505,-1.5,"1309.449951171875, 1096.300048828125","1261.1500244140625, 1073.75"
AGI,6,1,5,-12366,-12.37,"23.63704490661621, 16.59563446044922, 39.5423469543457, 29.32539939880371, 68.38451385498047, 283.6499938964844","19.370779037475586, 13.613390922546387, 39.66660690307617, 28.56603240966797, 61.63304138183594, 314.25"
AHL,0,0,0,0,0.0,,
AHLUCONT,1,1,0,1460,1.46,306.1000061035156,317.79998779296875
AIAENG,3,2,1,10680,10.68,"313.29998779296875, 169.14999389648438, 939.7999877929688","273.1000061035156, 241.5, 990.9000244140625"
AJANTPHARM,4,3,1,4852,4.85,"913.4000244140625, 758.7999877929688, 779.0333251953125, 690.1333618164062","994.2999877929688, 847.1666870117188, 790.4666748046875, 660.2666625976562"
AJMERA,2,1,1,3456,3.46,"121.19999694824219, 224.35000610351562","167.3000030517578, 159.1999969482422"
AKZOINDIA,7,5,2,9265,9.27,"348.8500061035156, 416.5, 901.7999877929688, 1509.5, 1749.300048828125, 2100.10009765625, 1885.1500244140625","350.5, 442.3999938964844, 865.5999755859375, 1912.0999755859375, 1759.8499755859375, 2165.199951171875, 1945.0"
ALEMBICLTD,4,1,3,-9204,-9.2,"31.635944366455078, 10.850000381469727, 47.45000076293945, 66.94999694824219","27.926267623901367, 9.350000381469727, 42.20000076293945, 72.1500015258789"
ALICON,7,3,4,-2723,-2.72,"21.5, 60.400001525878906, 73.25, 69.30000305175781, 67.0, 585.9000244140625, 251.14999389648438","23.450000762939453, 63.0, 66.80000305175781, 62.0, 67.0, 627.0, 248.14999389648438"
ALKEM,2,0,2,-3867,-3.87,"1794.3499755859375, 3225.14990234375","1669.0, 2974.64990234375"
ALKYLAMINE,3,1,2,-5741,-5.74,"3179.60009765625, 2929.75, 2535.75","2729.75, 2967.5, 2380.85009765625"
ALLCARGO,4,2,2,244,0.24,"12.6875, 26.25, 19.799999237060547, 78.01249694824219","11.40625, 27.125, 23.412500381469727, 68.6624984741211"
ALOKINDS,7,2,5,-6139,-6.14,"58.002323150634766, 26.64697265625, 21.107994079589844, 9.5, 3.450000047683716, 3.9000000953674316, 3.0","52.74996566772461, 26.197866439819336, 18.612960815429688, 7.849999904632568, 3.700000047683716, 4.400000095367432, 3.049999952316284"
AMBER,2,1,1,363,0.36,"816.5999755859375, 2116.699951171875","783.2000122070312, 2256.199951171875"
AMBUJACEM,8,4,4,2373,2.37,"70.05000305175781, 174.0500030517578, 202.1999969482422, 229.0500030517578, 230.6999969482422, 191.5500030517578, 372.20001220703125, 423.6000061035156","70.8499984741211, 180.4499969482422, 197.75, 229.35000610351562, 241.35000610351562, 193.60000610351562, 369.3999938964844, 425.8999938964844"
AMIORG,0,0,0,0,0.0,,
AMRUTANJAN,2,1,1,2443,2.44,"215.22500610351562, 738.25","254.5500030517578, 657.9000244140625"
ANANDRATHI,0,0,0,0,0.0,,
ANANTRAJ,11,4,7,4123,4.12,"127.06932067871094, 36.97862243652344, 34.34931182861328, 34.37034606933594, 23.18000030517578, 17.521724700927734, 15.923104286193848, 15.649656295776367, 20.88724136352539, 9.528620719909668, 73.9000015258789","153.7620849609375, 21.749656677246094, 53.13310623168945, 27.471036911010742, 20.193103790283203, 17.416553497314453, 15.397241592407227, 16.722415924072266, 15.712759017944336, 9.002758979797363, 87.19999694824219"
ANDHRAPAP,5,3,2,14253,14.25,"182.1999969482422, 209.10000610351562, 320.25, 432.45001220703125, 242.64999389648438","262.95001220703125, 247.8000030517578, 300.3999938964844, 443.5, 218.89999389648438"
ANGELONE,1,1,0,3239,3.24,1230.050048828125,1345.5
ANUP,2,2,0,8538,8.54,"191.5500030517578, 434.2250061035156","230.6999969482422, 471.29998779296875"
ANURAS,2,2,0,10682,10.68,"865.3499755859375, 986.5999755859375","1129.300048828125, 1052.050048828125"
APARINDS,5,4,1,595,0.6,"161.2460174560547, 176.3000030517578, 146.0, 117.8499984741211, 615.75","167.99583435058594, 129.85000610351562, 161.35000610351562, 124.9000015258789, 660.25"
APCOTEXIND,5,3,2,9933,9.93,"4.224999904632568, 3.700000047683716, 85.55999755859375, 210.39999389648438, 487.54998779296875","4.09499979019165, 3.5, 113.81999969482422, 215.52000427246094, 502.1499938964844"
APLAPOLLO,2,2,0,3890,3.89,"144.18499755859375, 151.77999877929688","158.88999938964844, 155.2899932861328"
APLLTD,2,0,2,-1195,-1.2,"627.4500122070312, 556.1500244140625","612.3499755859375, 546.5499877929688"
APOLLO,0,0,0,0,0.0,,
APOLLOHOSP,2,2,0,3053,3.05,"1106.300048828125, 4212.2998046875","1204.800048828125, 4322.89990234375"
APOLLOPIPE,0,0,0,0,0.0,,
APOLLOTYRE,10,6,4,7069,7.07,"30.799999237060547, 39.349998474121094, 18.25, 66.05000305175781, 163.3000030517578, 239.0500030517578, 222.75, 181.64999389648438, 108.0, 205.0","32.54999923706055, 37.5, 21.25, 59.099998474121094, 183.0500030517578, 235.9499969482422, 206.0500030517578, 190.3000030517578, 108.25, 218.35000610351562"
APTUS,1,0,1,-4358,-4.36,359.75,307.29998779296875
ARE&M,0,0,0,0,0.0,,
ARMANFIN,2,1,1,-4121,-4.12,"226.4499969482422, 445.1000061035156","186.64999389648438, 455.29998779296875"
ARVIND,8,2,6,8061,8.06,"25.150421142578125, 21.900440216064453, 17.911827087402344, 19.130569458007812, 6.980072021484375, 90.94999694824219, 32.400001525878906, 98.30000305175781","22.916059494018555, 18.65045928955078, 17.745634078979492, 16.619220733642578, 12.630607604980469, 83.3499984741211, 28.700000762939453, 95.30000305175781"
ARVINDFASN,2,0,2,-10034,-10.03,"163.5438690185547, 356.3999938964844","119.70435333251953, 325.6000061035156"
ARVSMART,1,1,0,398,0.4,124.0999984741211,124.6500015258789
ASAHIINDIA,6,3,3,5794,5.79,"41.80349349975586, 41.352012634277344, 37.70000076293945, 208.6999969482422, 176.64999389648438, 601.6500244140625","38.49570083618164, 41.20458984375, 43.599998474121094, 205.5, 171.85000610351562, 588.0999755859375"
ASHAPURMIN,5,3,2,25720,25.72,"113.80000305175781, 27.549999237060547, 65.05000305175781, 28.200000762939453, 95.9000015258789","101.94999694824219, 54.599998474121094, 67.80000305175781, 25.450000762939453, 102.9000015258789"
ASHIANA,4,2,2,-4497,-4.5,"34.209999084472656, 160.89999389648438, 150.5500030517578, 59.20000076293945","34.63999938964844, 162.64999389648438, 126.3499984741211, 59.29999923706055"
ASHOKA,5,2,3,2343,2.34,"36.900001525878906, 125.0, 105.83333587646484, 130.60000610351562, 80.5","41.43333435058594, 133.0, 105.5999984741211, 124.4000015258789, 78.19999694824219"
ASHOKLEY,9,3,6,-7476,-7.48,"20.575000762939453, 16.774999618530273, 9.074999809265137, 23.75, 15.149999618530273, 90.25, 90.75, 91.30000305175781, 127.0999984741211","17.899999618530273, 13.274999618530273, 10.75, 20.100000381469727, 17.200000762939453, 79.5, 90.6500015258789, 86.94999694824219, 137.5"
ASIANPAINT,3,2,1,8171,8.17,"89.18000030517578, 970.7000122070312, 3333.75","108.0, 1024.199951171875, 3391.60009765625"
ASKAUTOLTD,0,0,0,0,0.0,,
ASTEC,5,3,2,1106,1.11,"53.5, 25.0, 224.25, 409.45001220703125, 1067.449951171875","48.79999923706055, 25.0, 240.25, 368.8999938964844, 1284.4000244140625"
ASTERDM,1,1,0,2275,2.27,123.8499984741211,132.1999969482422
ASTRAL,5,5,0,31895,31.89,"2.8350000381469727, 194.40005493164062, 202.5000457763672, 467.25762939453125, 1569.300048828125","4.536001205444336, 190.8675537109375, 246.44256591796875, 507.3751220703125, 1674.3375244140625"
ASTRAMICRO,4,0,4,-12429,-12.43,"126.4000015258789, 122.9000015258789, 108.30000305175781, 98.9000015258789","110.44999694824219, 111.69999694824219, 103.1500015258789, 87.44999694824219"
ASTRAZEN,4,2,2,-1026,-1.03,"835.7999877929688, 811.5999755859375, 3907.949951171875, 2749.75","655.4500122070312, 879.4500122070312, 3777.949951171875, 3007.550048828125"
ATGL,2,2,0,19650,19.65,"117.44999694824219, 708.7999877929688","152.60000610351562, 987.9500122070312"
ATUL,3,2,1,119,0.12,"2390.10009765625, 8886.9501953125, 6995.25","2397.75, 9162.4501953125, 6796.64990234375"
AUBANK,2,1,1,320,0.32,"633.9000244140625, 633.5999755859375","619.2000122070312, 653.0999755859375"
AURIONPRO,6,3,3,20448,20.45,"67.6406021118164, 71.60952758789062, 121.05218505859375, 129.25, 107.0999984741211, 46.0","119.70106506347656, 71.77841186523438, 118.94105529785156, 154.35000610351562, 73.5999984741211, 44.0"
AUROPHARMA,7,4,3,4508,4.51,"16.84000015258789, 18.815000534057617, 57.5, 684.5999755859375, 481.3999938964844, 734.3499755859375, 462.75","16.03499984741211, 21.795000076293945, 56.04999923706055, 718.5999755859375, 505.5, 634.4500122070312, 518.0999755859375"
AUTOAXLES,11,4,7,2157,2.16,"543.4000244140625, 537.5, 291.8999938964844, 96.55000305175781, 415.20001220703125, 411.8999938964844, 260.6499938964844, 609.9000244140625, 1243.5, 970.2000122070312, 564.4500122070312","524.6500244140625, 460.20001220703125, 238.4499969482422, 159.0500030517578, 424.20001220703125, 373.79998779296875, 231.5, 636.4000244140625, 1135.75, 969.2000122070312, 517.9000244140625"
AVALON,0,0,0,0,0.0,,
AVANTIFEED,3,3,0,14304,14.3,"187.03334045410156, 367.3999938964844, 440.54998779296875","225.14999389648438, 453.45001220703125, 463.8999938964844"
AWL,1,0,1,-1778,-1.78,436.1000061035156,409.95001220703125
AXISBANK,2,2,0,14814,14.81,"111.45999908447266, 444.1499938964844","155.7899932861328, 472.3999938964844"
AXISCADES,9,5,4,43315,43.31,"16.25, 11.649999618530273, 13.100000381469727, 12.75, 43.45000076293945, 55.79999923706055, 157.5, 90.6500015258789, 51.150001525878906","28.5, 9.75, 11.550000190734863, 16.75, 50.54999923706055, 66.5, 200.4499969482422, 82.55000305175781, 53.349998474121094"
AZAD,0,0,0,0,0.0,,
BAJAJ-AUTO,7,5,2,7439,7.44,"294.1000061035156, 237.375, 1604.300048828125, 2316.10009765625, 2710.5, 3564.64990234375, 3750.699951171875","297.45001220703125, 267.5249938964844, 1617.199951171875, 2541.949951171875, 2826.050048828125, 3530.35009765625, 3616.050048828125"
BAJAJCON,3,2,1,8907,8.91,"115.5999984741211, 146.14999389648438, 162.64999389648438","115.30000305175781, 175.5500030517578, 161.1999969482422"
BAJAJELEC,7,6,1,47730,47.73,"84.46941375732422, 39.53535842895508, 215.30519104003906, 174.44769287109375, 221.3649444580078, 342.9733581542969, 1066.29345703125","77.1242446899414, 77.64759063720703, 247.66981506347656, 210.16357421875, 238.9474334716797, 379.5050354003906, 1160.1580810546875"
BAJAJFINSV,6,5,1,30914,30.91,"14.707470893859863, 21.43734359741211, 187.53500366210938, 584.5150146484375, 1504.760009765625, 1451.050048828125","16.942575454711914, 35.761653900146484, 182.06500244140625, 620.5900268554688, 1696.2149658203125, 1528.0"
BAJAJHIND,12,4,8,19051,19.05,"165.22958374023438, 164.68064880371094, 144.3278045654297, 61.56522750854492, 63.6342887878418, 63.33871078491211, 34.75, 30.399999618530273, 20.649999618530273, 6.900000095367432, 6.5, 5.599999904632568","166.0740966796875, 136.5160369873047, 155.34873962402344, 48.60190200805664, 119.87906646728516, 57.13151550292969, 33.650001525878906, 29.350000381469727, 18.899999618530273, 8.300000190734863, 6.25, 6.150000095367432"
BAJAJHLDNG,3,2,1,3662,3.66,"297.8999938964844, 807.5, 2543.0","339.8999938964844, 815.1500244140625, 2656.10009765625"
BAJEL,0,0,0,0,0.0,,
BAJFINANCE,6,2,4,5617,5.62,"38.25309753417969, 42.67184829711914, 6.786495208740234, 2831.0, 7209.10009765625, 7245.25","34.403690338134766, 39.35389709472656, 8.792810440063477, 3251.300048828125, 7306.25, 6923.5498046875"
BALAMINES,4,1,3,8333,8.33,"339.25, 495.70001220703125, 331.8500061035156, 2668.5","518.8499755859375, 437.0, 323.95001220703125, 2438.699951171875"
BALKRISIND,3,2,1,19457,19.46,"18.574420928955078, 995.5, 2042.050048828125","31.450653076171875, 914.3499755859375, 2131.25"
BALMLAWRIE,6,0,6,-10658,-10.66,"39.52857208251953, 56.595237731933594, 52.68571472167969, 152.39999389648438, 126.69999694824219, 124.05000305175781","37.56190490722656, 53.88571548461914, 50.82857131958008, 139.8333282470703, 115.3499984741211, 112.19999694824219"
BALRAMCHIN,7,2,5,-16294,-16.29,"59.900001525878906, 48.79999923706055, 59.79999923706055, 50.400001525878906, 76.44999694824219, 134.0500030517578, 395.54998779296875","47.29999923706055, 51.70000076293945, 59.650001525878906, 39.849998474121094, 71.05000305175781, 125.5, 378.25"
BANARISUG,6,4,2,20775,20.77,"585.4000244140625, 974.7999877929688, 816.9500122070312, 755.0999755859375, 991.2000122070312, 1021.7999877929688","716.0, 806.7999877929688, 800.0, 904.0999755859375, 1115.5, 1276.0"
BANCOINDIA,6,2,4,7850,7.85,"22.5, 75.44999694824219, 127.44999694824219, 132.75, 226.9499969482422, 73.25","31.049999237060547, 73.1500015258789, 123.55000305175781, 131.1999969482422, 192.5500030517578, 79.0"
BANDHANBNK,2,0,2,-8029,-8.03,"550.1500244140625, 319.29998779296875","403.95001220703125, 345.1000061035156"
BANKBARODA,8,4,4,10729,10.73,"47.20000076293945, 159.55999755859375, 144.14999389648438, 147.0, 169.89999389648438, 148.9499969482422, 104.9000015258789, 51.349998474121094","55.13999938964844, 145.1300048828125, 163.38999938964844, 157.89999389648438, 169.10000610351562, 136.85000610351562, 101.9000015258789, 61.45000076293945"
BANKINDIA,7,4,3,-59,-0.06,"311.20001220703125, 209.89999389648438, 228.5, 101.25, 75.9000015258789, 48.79999923706055, 45.04999923706055","276.5, 217.14999389648438, 234.14999389648438, 111.6500015258789, 70.4000015258789, 47.04999923706055, 48.70000076293945"
BARBEQUE,2,1,1,-564,-0.56,"1165.550048828125, 660.2999877929688","1138.25, 678.5"
BASF,6,4,2,6619,6.62,"227.1999969482422, 255.0, 209.85000610351562, 951.25, 877.5, 1480.550048828125","265.3500061035156, 263.70001220703125, 257.29998779296875, 794.1500244140625, 906.4000244140625, 1363.5"
BATAINDIA,8,5,3,6920,6.92,"101.19999694824219, 85.25, 91.4749984741211, 51.974998474121094, 401.20001220703125, 600.2000122070312, 479.45001220703125, 1474.6500244140625","111.4000015258789, 84.69999694824219, 82.17500305175781, 61.25, 417.57501220703125, 536.2999877929688, 508.54998779296875, 1584.1500244140625"
BAYERCROP,7,4,3,-3437,-3.44,"916.3499755859375, 4543.25, 4037.60009765625, 3351.25, 5161.5, 4937.39990234375, 4228.64990234375","948.6500244140625, 4556.0498046875, 4484.64990234375, 3593.89990234375, 4410.39990234375, 4449.75, 4380.9501953125"
BBL,5,2,3,9539,9.54,"275.0, 325.25, 678.125, 479.6000061035156, 441.0249938964844","454.9750061035156, 332.07501220703125, 572.2000122070312, 424.875, 381.07501220703125"
BBOX,4,2,2,-2168,-2.17,"30.219999313354492, 19.219999313354492, 10.550000190734863, 137.35000610351562","22.395000457763672, 18.200000762939453, 12.5, 138.35000610351562"
BBTC,9,4,5,8895,8.89,"110.41999816894531, 27.1200008392334, 103.8499984741211, 498.3999938964844, 403.20001220703125, 1380.25, 1299.300048828125, 1135.199951171875, 1002.9500122070312","87.0, 39.619998931884766, 120.55000305175781, 488.0, 375.3500061035156, 1324.0999755859375, 1246.6500244140625, 1190.449951171875, 997.5"
BDL,1,1,0,13464,13.46,581.375,856.1749877929688
BECTORFOOD,1,1,0,3216,3.22,314.8500061035156,348.70001220703125
BEL,3,2,1,2062,2.06,"11.595454216003418, 31.083332061767578, 29.549999237060547","12.22828197479248, 29.049999237060547, 31.950000762939453"
BEML,9,4,5,17672,17.67,"906.1570434570312, 426.57049560546875, 445.51983642578125, 1078.932861328125, 853.7305297851562, 634.0446166992188, 537.8662109375, 1555.7401123046875, 1436.550048828125","866.9529418945312, 635.813232421875, 424.843994140625, 883.7968139648438, 897.65087890625, 762.3526611328125, 539.5084838867188, 1482.800048828125, 1620.800048828125"
BEPL,4,2,2,97,0.1,"14.033332824707031, 15.433333396911621, 58.93333435058594, 48.70000076293945","17.66666603088379, 15.866665840148926, 45.70000076293945, 47.599998474121094"
BERGEPAINT,4,2,2,1130,1.13,"13.244047164916992, 11.93452262878418, 68.4077377319336, 561.4166870117188","14.598214149475098, 11.755951881408691, 72.38095092773438, 514.1666870117188"
BFINVEST,4,0,4,-14789,-14.79,"334.3500061035156, 265.5, 307.75, 302.75","264.04998779296875, 220.85000610351562, 297.45001220703125, 277.25"
BFUTILITIE,8,5,3,29503,29.5,"1435.6844482421875, 439.5625915527344, 321.1000061035156, 575.0, 393.75, 179.5500030517578, 204.10000610351562, 383.29998779296875","1386.8233642578125, 585.5834350585938, 315.54998779296875, 602.0999755859375, 453.04998779296875, 268.6499938964844, 218.4499969482422, 332.8500061035156"
BHAGCHEM,0,0,0,0,0.0,,
BHARATFORG,5,2,3,-1011,-1.01,"48.92499923706055, 165.10000610351562, 679.0499877929688, 446.3500061035156, 326.04998779296875","62.42499923706055, 138.97500610351562, 601.0999755859375, 453.8500061035156, 319.3500061035156"
BHARATRAS,1,1,0,1521,1.52,115.0,115.0999984741211
BHARTIARTL,4,1,3,-17,-0.02,"404.77716064453125, 339.77398681640625, 297.1895751953125, 303.72369384765625","394.7281494140625, 369.9210510253906, 276.1452331542969, 285.7886657714844"
BHEL,11,2,9,-9655,-9.65,"154.96665954589844, 133.6999969482422, 167.76666259765625, 83.5999984741211, 97.26666259765625, 96.73332977294922, 80.5999984741211, 74.94999694824219, 56.54999923706055, 28.0, 32.849998474121094","143.76666259765625, 116.16666412353516, 165.26666259765625, 80.33333587646484, 92.73332977294922, 85.93333435058594, 68.5, 70.80000305175781, 53.29999923706055, 35.70000076293945, 35.900001525878906"
BIKAJI,0,0,0,0,0.0,,
BIOCON,8,5,3,8654,8.65,"31.304166793823242, 23.858333587646484, 61.42499923706055, 40.14999771118164, 246.10000610351562, 404.45001220703125, 245.1999969482422, 249.64999389648438","31.266666412353516, 23.54166603088379, 58.94166564941406, 43.77499771118164, 281.6499938964844, 386.3500061035156, 265.5, 268.3999938964844"
BIRLACORPN,5,3,2,4256,4.26,"261.1000061035156, 130.0, 776.5499877929688, 524.4000244140625, 518.5","281.20001220703125, 139.39999389648438, 760.2999877929688, 502.8999938964844, 578.8499755859375"
BLKASHYAP,4,2,2,39315,39.32,"61.97249984741211, 16.975000381469727, 50.400001525878906, 6.0","67.85749816894531, 39.67499923706055, 43.45000076293945, 5.550000190734863"
BLS,2,1,1,-169,-0.17,"46.662498474121094, 16.274999618530273","39.57500076293945, 19.549999237060547"
BLUEDART,10,3,7,-1992,-1.99,"564.4000244140625, 737.4500122070312, 1968.6500244140625, 5961.64990234375, 5203.5, 3097.14990234375, 2484.199951171875, 7706.0498046875, 7245.5498046875, 6311.2998046875","560.0, 682.7000122070312, 2047.550048828125, 5845.75, 4878.39990234375, 3371.449951171875, 2406.699951171875, 6315.5, 6728.14990234375, 7203.5498046875"
BLUEJET,0,0,0,0,0.0,,
BLUESTARCO,7,3,4,-11258,-11.26,"212.72500610351562, 77.69999694824219, 185.72500610351562, 94.25, 95.32499694824219, 338.82501220703125, 317.8999938964844","144.97500610351562, 86.0, 184.39999389648438, 93.25, 88.57499694824219, 311.45001220703125, 320.57501220703125"
BOMDYEING,9,3,6,-18359,-18.36,"33.599998474121094, 78.68000030517578, 68.80000305175781, 58.29999923706055, 49.20000076293945, 134.9499969482422, 94.44999694824219, 72.3499984741211, 92.19999694824219","34.79999923706055, 71.06999969482422, 71.0999984741211, 72.30000305175781, 43.400001525878906, 112.55000305175781, 69.05000305175781, 59.0, 83.05000305175781"
BOROLTD,1,1,0,1506,1.51,405.04998779296875,423.6499938964844
BORORENEW,3,0,3,-11282,-11.28,"44.56898498535156, 132.8000030517578, 441.1000061035156","44.25450134277344, 77.75, 439.8999938964844"
BOSCHLTD,8,3,5,874,0.87,"4142.7998046875, 4122.60009765625, 20784.5, 22130.75, 19404.80078125, 15305.349609375, 11418.099609375, 15229.599609375","4111.9501953125, 3933.050048828125, 19664.0, 21583.25, 18367.5, 16142.599609375, 13078.650390625, 17115.80078125"
BPCL,9,5,4,5169,5.17,"60.258331298828125, 60.06666564941406, 59.56666564941406, 96.85832977294922, 110.41666412353516, 470.1000061035156, 374.0, 373.0, 341.1499938964844","61.04999923706055, 51.875, 57.20000076293945, 110.45833587646484, 119.8499984741211, 526.5999755859375, 413.79998779296875, 381.1000061035156, 330.5"
BRIGADE,3,2,1,31266,31.27,"34.03333282470703, 135.9499969482422, 487.6499938964844","66.43333435058594, 140.4499969482422, 474.70001220703125"
BRITANNIA,3,2,1,5420,5.42,"132.2449951171875, 3169.75, 2944.14990234375","139.06500244140625, 3115.39990234375, 3266.60009765625"
BSE,5,3,2,-2458,-2.46,"274.6666564941406, 203.71665954589844, 188.0833282470703, 177.8000030517578, 522.9000244140625","276.3999938964844, 206.89999389648438, 184.88333129882812, 151.0, 557.7000122070312"
BSHSL,0,0,0,0,0.0,,
BSOFT,8,4,4,17361,17.36,"28.56398582458496, 7.956888198852539, 50.212318420410156, 66.98084259033203, 68.62816619873047, 89.0798568725586, 305.25, 343.5","23.79296112060547, 13.862391471862793, 48.54945373535156, 75.83909606933594, 63.74835205078125, 81.99324798583984, 298.75, 358.8999938964844"
CAMPUS,0,0,0,0,0.0,,
CAMS,0,0,0,0,0.0,,
CANBK,13,8,5,29960,29.96,"43.01079559326172, 42.213218688964844, 41.9019660949707, 38.517127990722656, 121.82501220703125, 90.82649993896484, 83.93038177490234, 50.23761749267578, 51.424259185791016, 40.06364822387695, 45.43000030517578, 20.110000610351562, 20.760000228881836","55.28569793701172, 47.543365478515625, 36.834434509277344, 55.2078857421875, 122.91438293457031, 83.86229705810547, 77.98745727539062, 48.32148742675781, 55.56776428222656, 40.151187896728516, 44.27000045776367, 20.3700008392334, 25.790000915527344"
CANFINHOME,5,2,3,-923,-0.92,"9.534463882446289, 288.8999938964844, 337.8500061035156, 596.0999755859375, 553.0499877929688","9.736542701721191, 250.6999969482422, 365.3999938964844, 633.8499755859375, 535.0499877929688"
CANTABIL,2,2,0,6667,6.67,"3.559999942779541, 3.7899999618530273","4.099999904632568, 4.179999828338623"
CAPACITE,4,1,3,-8066,-8.07,"356.8500061035156, 241.9499969482422, 226.8000030517578, 111.80000305175781","310.6499938964844, 248.85000610351562, 227.0500030517578, 93.44999694824219"
CAPLIPOINT,1,1,0,884,0.88,231.4600067138672,241.0399932861328
CARBORUNIV,1,0,1,-4162,-4.16,278.3500061035156,248.10000610351562
CARERATING,4,2,2,793,0.79,"1299.699951171875, 1011.0, 638.9500122070312, 419.45001220703125","1295.800048828125, 994.4500122070312, 655.2000122070312, 423.6499938964844"
CARTRADE,1,0,1,-564,-0.56,649.8499755859375,622.75
CARYSIL,2,1,1,-1913,-1.91,"695.75, 512.4000244140625","609.7000122070312, 545.5"
CASTROLIND,6,2,4,-2315,-2.31,"122.9124984741211, 156.89999389648438, 231.5, 198.14999389648438, 151.0, 136.0500030517578","119.9124984741211, 147.0749969482422, 220.75, 187.47500610351562, 151.25, 152.14999389648438"
CCL,5,4,1,26942,26.94,"7.989999771118164, 193.1999969482422, 308.04998779296875, 225.85000610351562, 212.1999969482422","13.274999618530273, 193.10000610351562, 320.8500061035156, 234.39999389648438, 234.60000610351562"
CDSL,3,2,1,2952,2.95,"242.5500030517578, 204.64999389648438, 1248.9000244140625","233.5500030517578, 232.5, 1245.9000244140625"
CEATLTD,5,4,1,27994,27.99,"54.5, 1264.1500244140625, 957.0999755859375, 914.4000244140625, 1557.199951171875","89.0, 1306.4000244140625, 1008.7999877929688, 868.9500122070312, 1927.800048828125"
CELLO,0,0,0,0,0.0,,
CENTRALBK,9,2,7,9642,9.64,"36.363792419433594, 108.05000305175781, 102.05000305175781, 78.19999694824219, 74.25, 36.650001525878906, 35.650001525878906, 22.799999237060547, 13.850000381469727","64.73180389404297, 89.80000305175781, 100.8499984741211, 69.6500015258789, 82.05000305175781, 31.100000381469727, 31.5, 22.149999618530273, 13.550000190734863"
CENTUM,9,4,5,-4584,-4.58,"168.64999389648438, 112.75, 57.0, 710.0999755859375, 581.0499877929688, 383.04998779296875, 398.8999938964844, 297.54998779296875, 494.20001220703125","178.64999389648438, 95.19999694824219, 75.6500015258789, 617.0, 507.3500061035156, 389.95001220703125, 323.75, 316.6000061035156, 486.25"
CENTURYPLY,9,8,1,36281,36.28,"30.25, 53.20000076293945, 27.299999237060547, 175.0, 170.85000610351562, 196.0500030517578, 282.3500061035156, 208.3000030517578, 159.1999969482422","43.04999923706055, 57.5, 36.95000076293945, 192.10000610351562, 184.0500030517578, 250.14999389648438, 316.3999938964844, 173.35000610351562, 163.1999969482422"
CENTURYTEX,12,5,7,-18828,-18.83,"609.25, 219.9499969482422, 359.45001220703125, 322.70001220703125, 241.10000610351562, 554.2000122070312, 1262.550048828125, 978.1500244140625, 921.0, 933.0999755859375, 644.2000122070312, 333.3999938964844","605.5499877929688, 229.3000030517578, 330.95001220703125, 260.54998779296875, 275.8500061035156, 585.0, 947.1500244140625, 821.5499877929688, 922.9500122070312, 917.2000122070312, 506.75, 331.54998779296875"
CERA,2,2,0,2459,2.46,"1829.9000244140625, 4727.2001953125","1844.949951171875, 4989.10009765625"
CESC,4,2,2,12208,12.21,"20.64809799194336, 42.43633270263672, 89.40626525878906, 85.6500015258789","31.510793685913086, 48.343482971191406, 73.69126892089844, 78.0"
CGCL,3,2,1,12901,12.9,"14.236091613769531, 33.56123352050781, 701.7000122070312","20.32781410217285, 28.03706169128418, 765.9500122070312"
CGPOWER,4,1,3,-11073,-11.07,"68.94999694824219, 44.849998474121094, 42.70000076293945, 7.949999809265137","77.6500015258789, 37.599998474121094, 37.599998474121094, 6.0"
CHALET,0,0,0,0,0.0,,
CHAMBLFERT,5,1,4,-13156,-13.16,"35.45000076293945, 165.14999389648438, 153.10000610351562, 180.9499969482422, 350.25","36.54999923706055, 151.5500030517578, 148.1999969482422, 140.89999389648438, 319.45001220703125"
CHEMPLASTS,1,1,0,637,0.64,459.6499938964844,441.95001220703125
CHENNPETRO,9,6,3,28526,28.53,"212.64999389648438, 196.25, 214.5500030517578, 362.8500061035156, 115.25, 65.05000305175781, 273.29998779296875, 77.5999984741211, 110.55000305175781","264.95001220703125, 207.25, 248.8000030517578, 338.45001220703125, 187.5500030517578, 69.55000305175781, 253.5500030517578, 79.69999694824219, 100.3499984741211"
CHOICEIN,0,0,0,0,0.0,,
CHOLAFIN,5,3,2,23367,23.37,"22.591999053955078, 7.199999809265137, 205.77000427246094, 262.79998779296875, 189.39999389648438","24.525999069213867, 12.399999618530273, 194.74000549316406, 251.94000244140625, 202.5"
CHOLAHLDNG,5,3,2,17054,17.05,"55.42741012573242, 45.30219268798828, 30.930912017822266, 19.98914337158203, 486.3999938964844","54.12092971801758, 51.14868927001953, 25.313047409057617, 28.97119140625, 516.1500244140625"
CIEINDIA,6,4,2,11029,11.03,"43.54999923706055, 49.150001525878906, 191.89999389648438, 245.1999969482422, 164.75, 221.1999969482422","59.599998474121094, 50.400001525878906, 198.64999389648438, 231.10000610351562, 173.6999969482422, 194.85000610351562"
CIGNITITEC,2,1,1,-2436,-2.44,"267.5, 335.25","264.45001220703125, 297.5"
CIPLA,3,2,1,2683,2.68,"527.4000244140625, 554.5499877929688, 953.0499877929688","572.9500122070312, 528.9000244140625, 1014.9500122070312"
CLEAN,0,0,0,0,0.0,,
CMSINFO,1,0,1,-1330,-1.33,274.1000061035156,260.1000061035156
COALINDIA,6,4,2,4455,4.45,"324.70001220703125, 294.45001220703125, 313.0, 270.8500061035156, 237.1999969482422, 125.55000305175781","302.54998779296875, 287.95001220703125, 328.0, 286.45001220703125, 252.14999389648438, 135.4499969482422"
COCHINSHIP,2,1,1,2014,2.01,"150.14999389648438, 167.14999389648438","164.4250030517578, 161.5500030517578"
COFORGE,4,3,1,20363,20.36,"141.75, 68.5, 1451.699951171875, 3809.60009765625","144.0, 109.25, 1409.199951171875, 4036.300048828125"
COLPAL,3,3,0,5894,5.89,"171.9499969482422, 1542.25, 1507.3499755859375","181.5, 1654.550048828125, 1595.0999755859375"
CONCOR,7,4,3,1228,1.23,"151.8506622314453, 196.24533081054688, 397.87200927734375, 379.343994140625, 604.75, 417.8999938964844, 670.9500122070312","135.49867248535156, 201.53599548339844, 432.9119873046875, 389.0880126953125, 588.3499755859375, 451.1000061035156, 661.7999877929688"
CONCORDBIO,0,0,0,0,0.0,,
CONFIPET,1,1,0,2484,2.48,65.1500015258789,71.69999694824219
COROMANDEL,6,2,4,525,0.52,"54.25, 283.6499938964844, 224.1999969482422, 190.3000030517578, 415.3999938964844, 789.4500122070312","46.974998474121094, 256.3500061035156, 219.5, 224.10000610351562, 475.3999938964844, 773.9000244140625"
CRAFTSMAN,0,0,0,0,0.0,,
CREDITACC,1,0,1,-428,-0.43,522.25,514.0
CRISIL,8,5,3,7636,7.64,"230.81500244140625, 368.6549987792969, 377.2200012207031, 270.2049865722656, 960.5499877929688, 1951.8499755859375, 1613.550048828125, 1370.0","217.91000366210938, 374.70001220703125, 375.2699890136719, 301.2650146484375, 950.0999755859375, 2236.5, 1648.6500244140625, 1462.5999755859375"
CROMPTON,3,2,1,-700,-0.7,"228.0500030517578, 238.64999389648438, 289.54998779296875","213.9499969482422, 244.10000610351562, 293.8999938964844"
CSBBANK,2,2,0,672,0.67,"187.14999389648438, 200.0500030517578","190.75, 210.3000030517578"
CUB,7,4,3,8758,8.76,"16.25113868713379, 10.003010749816895, 39.6694221496582, 76.15702056884766, 157.64999389648438, 137.10000610351562, 133.1999969482422","13.968168258666992, 14.659067153930664, 40.661155700683594, 66.1156997680664, 168.14999389648438, 140.10000610351562, 123.4000015258789"
CUMMINSIND,7,5,2,3341,3.34,"132.14285278320312, 419.8500061035156, 870.5999755859375, 838.9500122070312, 768.1500244140625, 574.5499877929688, 392.3500061035156","143.60714721679688, 465.95001220703125, 920.4000244140625, 887.9000244140625, 673.0999755859375, 510.95001220703125, 401.6499938964844"
CUPID,3,0,3,-10155,-10.16,"12.764582633972168, 128.39999389648438, 135.0625","10.3125, 118.8499984741211, 121.15750122070312"
CYIENT,5,3,2,5189,5.19,"71.5, 128.89999389648438, 459.5, 465.3500061035156, 275.79998779296875","89.5, 110.05000305175781, 482.95001220703125, 406.75, 330.0"
CYIENTDLM,0,0,0,0,0.0,,
DABUR,2,1,1,290,0.29,"43.974998474121094, 584.0999755859375","45.57500076293945, 583.5999755859375"
DALBHARAT,3,1,2,408,0.41,"880.9000244140625, 673.2999877929688, 1599.6500244140625","800.2999877929688, 760.6500244140625, 1536.3499755859375"
DALMIASUG,7,7,0,35083,35.08,"371.6499938964844, 89.80000305175781, 15.699999809265137, 19.799999237060547, 153.8000030517578, 62.04999923706055, 109.1500015258789","363.6499938964844, 136.0, 17.25, 20.549999237060547, 166.35000610351562, 70.1500015258789, 123.8499984741211"
DATAMATICS,3,0,3,-20537,-20.54,"63.25, 141.4499969482422, 77.1500015258789","49.45000076293945, 104.4000015258789, 60.5"
DATAPATTNS,0,0,0,0,0.0,,
DBCORP,3,3,0,4825,4.83,"371.1499938964844, 186.9499969482422, 117.30000305175781","379.04998779296875, 186.35000610351562, 132.89999389648438"
DBL,2,1,1,-2068,-2.07,"838.0999755859375, 213.10000610351562","653.9500122070312, 238.1999969482422"
DBREALTY,9,3,6,-9200,-9.2,"71.94999694824219, 71.1500015258789, 60.45000076293945, 90.94999694824219, 50.900001525878906, 28.299999237060547, 11.550000190734863, 6.5, 108.19999694824219","72.19999694824219, 52.70000076293945, 69.19999694824219, 81.69999694824219, 49.349998474121094, 25.549999237060547, 10.949999809265137, 7.349999904632568, 103.0999984741211"
DCAL,5,3,2,-1083,-1.08,"94.7750015258789, 25.875, 26.024999618530273, 296.20001220703125, 83.69999694824219","97.375, 25.875, 34.5, 248.5500030517578, 64.55000305175781"
DCBBANK,7,6,1,36389,36.39,"23.600000381469727, 59.25, 94.30000305175781, 118.4000015258789, 195.10000610351562, 80.05000305175781, 117.80000305175781","42.29999923706055, 59.75, 94.1500015258789, 156.0, 185.1999969482422, 83.19999694824219, 122.4000015258789"
DCMSHRIRAM,5,3,2,25836,25.84,"29.799999237060547, 124.9000015258789, 329.8500061035156, 394.8999938964844, 317.3500061035156","48.400001525878906, 118.4000015258789, 384.5, 371.04998779296875, 339.25"
DCMSRIND,1,0,1,-3428,-3.43,91.19999694824219,78.55000305175781
DCXINDIA,0,0,0,0,0.0,,
DEEPAKFERT,4,1,3,-6763,-6.76,"103.74832153320312, 342.6118469238281, 94.73094177246094, 605.0999755859375","88.86479949951172, 314.2022705078125, 103.21503448486328, 566.7000122070312"
DEEPAKNTR,4,4,0,12046,12.05,"65.0999984741211, 232.5500030517578, 1979.050048828125, 1888.199951171875","71.4000015258789, 274.1499938964844, 2036.0, 2073.800048828125"
DELHIVERY,2,0,2,-2940,-2.94,"345.6000061035156, 374.3999938964844","331.6499938964844, 349.20001220703125"
DELTACORP,7,2,5,-9289,-9.29,"24.4999942779541, 29.649999618530273, 77.0999984741211, 66.8499984741211, 124.80000305175781, 85.0999984741211, 211.4499969482422","24.4999942779541, 24.200000762939453, 75.8499984741211, 57.70000076293945, 143.0, 86.80000305175781, 198.39999389648438"
DEN,6,2,4,2029,2.03,"77.8499984741211, 160.85000610351562, 60.20000076293945, 50.900001525878906, 52.650001525878906, 36.849998474121094","60.95000076293945, 152.6999969482422, 88.1500015258789, 48.25, 56.099998474121094, 32.5"
DEVYANI,2,1,1,2498,2.5,"161.39999389648438, 166.35000610351562","184.5, 154.0"
DHANI,8,6,2,43728,43.73,"384.45001220703125, 28.920673370361328, 8.191693305969238, 19.72999382019043, 171.25, 118.05000305175781, 65.3499984741211, 38.400001525878906","418.29998779296875, 53.74550247192383, 10.439414024353027, 24.12553596496582, 214.35000610351562, 114.05000305175781, 48.0, 34.75"
DHANUKA,1,1,0,3368,3.37,720.2999877929688,799.9500122070312
DIACABS,8,2,6,-17503,-17.5,"12390.03125, 4515.0, 4705.0, 315.0, 200.0, 160.0, 75.0, 108.25","12240.0302734375, 4380.0, 3935.0, 180.0, 155.0, 130.0, 60.0, 160.14999389648438"
DIAMONDYD,4,1,3,-6469,-6.47,"931.9500122070312, 917.5999755859375, 608.9000244140625, 803.4000244140625","900.0499877929688, 930.9000244140625, 530.9500122070312, 765.2999877929688"
DISHTV,9,2,7,-4548,-4.55,"81.94999694824219, 37.20000076293945, 20.0, 53.5, 52.099998474121094, 90.5, 81.55000305175781, 75.4000015258789, 7.75","102.4000015258789, 27.149999618530273, 20.299999237060547, 55.75, 47.0, 88.30000305175781, 82.0, 73.0, 7.199999809265137"
DIVGIITTS,0,0,0,0,0.0,,
DIVISLAB,5,4,1,6706,6.71,"76.6449966430664, 1051.0999755859375, 647.25, 3831.64990234375, 3267.89990234375","89.58499908447266, 1099.449951171875, 672.9000244140625, 3626.85009765625, 3443.60009765625"
DIXON,2,1,1,2500,2.5,"453.7099914550781, 3878.75","441.0400085449219, 4388.60009765625"
DLF,9,5,4,14140,14.14,"230.25, 301.3999938964844, 268.54998779296875, 198.5500030517578, 176.4499969482422, 114.75, 134.9499969482422, 220.8000030517578, 178.10000610351562","406.5, 301.95001220703125, 222.8000030517578, 209.0500030517578, 140.14999389648438, 129.5, 150.4499969482422, 162.5500030517578, 177.5500030517578"
DMART,3,2,1,3643,3.64,"1492.5, 1397.9000244140625, 3511.949951171875","1606.6500244140625, 1482.699951171875, 3471.25"
DODLA,0,0,0,0,0.0,,
DOLATALGO,1,0,1,-122,-0.12,49.04999923706055,47.5
DOLLAR,3,1,2,-9722,-9.72,"173.0, 131.89999389648438, 473.8999938964844","109.5999984741211, 125.75, 499.04998779296875"
DOLPHIN,5,1,4,15310,15.31,"923.1428833007812, 880.0, 1019.2000122070312, 774.7999877929688, 375.6000061035156","970.8571166992188, 1704.0, 845.2000122070312, 703.2000122070312, 365.6000061035156"
DOMS,0,0,0,0,0.0,,
DPABHUSHAN,3,2,1,1939,1.94,"46.0, 48.400001525878906, 44.75","45.79999923706055, 50.0, 45.0"
DREAMFOLKS,1,0,1,-1036,-1.04,559.0,540.5
DREDGECORP,4,3,1,17964,17.96,"324.0, 296.04998779296875, 252.0500030517578, 290.75","496.20001220703125, 306.04998779296875, 259.8999938964844, 291.3500061035156"
DRREDDY,7,4,3,-6849,-6.85,"650.0499877929688, 732.2999877929688, 591.25, 468.6499938964844, 2702.25, 5163.10009765625, 4880.7001953125","621.5999755859375, 529.25, 623.0, 449.79998779296875, 2783.199951171875, 5309.14990234375, 4659.2001953125"
DYNAMATECH,5,1,4,-11749,-11.75,"1229.0, 1251.699951171875, 2417.050048828125, 2143.89990234375, 606.4000244140625","1197.699951171875, 1030.0, 1969.4000244140625, 2499.35009765625, 530.7999877929688"
E2E,1,1,0,16209,16.21,17.950000762939453,28.5
EASEMYTRIP,0,0,0,0,0.0,,
ECLERX,3,3,0,16831,16.83,"39.333343505859375, 853.3666381835938, 353.76666259765625","56.83334732055664, 916.5999755859375, 378.6666564941406"
EDELWEISS,6,3,3,-3549,-3.55,"32.24190139770508, 98.48238372802734, 106.88744354248047, 66.7269515991211, 24.89085578918457, 31.45815086364746","32.37702941894531, 83.26680755615234, 80.40206146240234, 59.02457046508789, 33.94453430175781, 32.97159957885742"
EICHERMOT,3,2,1,1963,1.96,"33.55500030517578, 30.110000610351562, 1654.844970703125","35.2400016784668, 27.510000228881836, 1833.4300537109375"
EIDPARRY,5,4,1,4604,4.6,"207.35000610351562, 211.0, 129.89999389648438, 173.75, 164.75","194.25, 214.89999389648438, 144.5500030517578, 185.8000030517578, 170.85000610351562"
EIHAHOTELS,5,2,3,8112,8.11,"61.60218048095703, 342.70001220703125, 385.70001220703125, 325.3500061035156, 234.9499969482422","73.39834594726562, 415.45001220703125, 377.79998779296875, 322.95001220703125, 236.5500030517578"
EIHOTEL,6,2,4,-8564,-8.56,"107.45130157470703, 52.76816940307617, 100.48511505126953, 176.15545654296875, 179.34312438964844, 86.01800537109375","85.56146240234375, 53.84707260131836, 118.139892578125, 145.1124725341797, 164.33656311035156, 80.5999984741211"
ELECON,9,4,5,36809,36.81,"117.19999694824219, 42.849998474121094, 73.5, 62.5, 62.349998474121094, 57.650001525878906, 33.900001525878906, 34.400001525878906, 26.100000381469727","87.94999694824219, 95.5, 70.5, 61.5, 58.0, 70.0999984741211, 33.75, 36.70000076293945, 24.649999618530273"
ELECTCAST,6,2,4,7201,7.2,"20.350000381469727, 24.75, 13.100000381469727, 22.600000381469727, 14.850000381469727, 14.5","30.549999237060547, 20.25, 13.600000381469727, 21.649999618530273, 13.649999618530273, 14.25"
ELGIEQUIP,5,2,3,2373,2.37,"13.5625, 71.92500305175781, 65.0999984741211, 151.75, 72.75","13.262499809265137, 67.57499694824219, 81.75, 137.875, 79.9000015258789"
EMAMILTD,7,6,1,20245,20.24,"36.53333282470703, 50.166664123535156, 126.6500015258789, 220.8000030517578, 449.8500061035156, 391.6499938964844, 486.8999938964844","34.133331298828125, 48.21666717529297, 134.75, 239.85000610351562, 484.45001220703125, 424.70001220703125, 625.5"
EMIL,1,0,1,-938,-0.94,76.69999694824219,73.55000305175781
EMSLIMITED,0,0,0,0,0.0,,
EMUDHRA,0,0,0,0,0.0,,
ENDURANCE,5,4,1,11273,11.27,"1203.5, 1012.25, 726.0499877929688, 1307.800048828125, 1344.300048828125","1114.4000244140625, 1090.449951171875, 870.75, 1411.699951171875, 1434.1500244140625"
ENGINERSIN,8,6,2,3074,3.07,"40.775001525878906, 115.3499984741211, 119.69999694824219, 86.69999694824219, 98.19999694824219, 89.6500015258789, 117.3499984741211, 75.4000015258789","41.670833587646484, 135.9250030517578, 103.5, 88.6500015258789, 108.625, 89.67500305175781, 119.5999984741211, 64.25"
EPIGRAL,0,0,0,0,0.0,,
EPL,5,3,2,22596,22.6,"37.95000076293945, 9.024999618530273, 7.875, 16.575000762939453, 109.69999694824219","44.224998474121094, 6.974999904632568, 14.149999618530273, 16.625, 108.75"
EQUITASBNK,1,1,0,842,0.84,44.5,46.0
ERIS,1,0,1,-1307,-1.31,451.20001220703125,433.1499938964844
ESABINDIA,5,2,3,-6237,-6.24,"365.75, 309.1000061035156, 638.1500244140625, 893.2000122070312, 3864.39990234375","344.1000061035156, 320.0, 597.0499877929688, 752.2000122070312, 3976.199951171875"
ESAFSFB,0,0,0,0,0.0,,
ESCORTS,10,5,5,6295,6.3,"118.8499984741211, 81.3499984741211, 141.64999389648438, 85.25, 69.5, 152.0, 139.25, 704.7000122070312, 580.3499755859375, 1220.0999755859375","119.44999694824219, 60.0, 137.10000610351562, 80.1500015258789, 73.5999984741211, 169.75, 169.25, 706.0999755859375, 659.3499755859375, 1184.3499755859375"
ETHOSLTD,0,0,0,0,0.0,,
EVEREADY,7,3,4,-17456,-17.46,"98.5999984741211, 71.30000305175781, 17.799999237060547, 243.4499969482422, 253.0, 80.6500015258789, 65.6500015258789","100.1500015258789, 67.8499984741211, 23.299999237060547, 249.9499969482422, 197.14999389648438, 45.29999923706055, 50.45000076293945"
EXIDEIND,5,3,2,14576,14.58,"51.79999923706055, 143.4499969482422, 121.1500015258789, 139.35000610351562, 195.1999969482422","70.8499984741211, 152.8000030517578, 119.75, 147.25, 193.10000610351562"
FACT,2,2,0,3444,3.44,"33.45000076293945, 41.20000076293945","34.849998474121094, 42.95000076293945"
FCL,1,1,0,888,0.89,54.04999923706055,55.599998474121094
FDC,4,3,1,-598,-0.6,"42.54999923706055, 33.5, 174.64999389648438, 253.5","44.04999923706055, 29.899999618530273, 180.0, 264.0"
FEDERALBNK,8,4,4,-2650,-2.65,"14.982560157775879, 21.454999923706055, 16.200000762939453, 41.04999923706055, 71.44999694824219, 98.30000305175781, 51.0, 135.64999389648438","16.211015701293945, 20.549999237060547, 14.03499984741211, 39.42499923706055, 73.9000015258789, 84.80000305175781, 53.900001525878906, 143.9499969482422"
FEDFINA,0,0,0,0,0.0,,
FIEMIND,4,2,2,-551,-0.55,"508.875, 254.6750030517578, 192.47500610351562, 177.8000030517578","425.0, 240.1999969482422, 216.35000610351562, 206.9250030517578"
FILATEX,1,1,0,669,0.67,1.3450000286102295,1.315000057220459
FINCABLES,7,3,4,11664,11.66,"83.19999694824219, 23.950000762939453, 255.60000610351562, 475.45001220703125, 388.29998779296875, 397.3500061035156, 285.3999938964844","91.3499984741211, 40.04999923706055, 238.6999969482422, 440.25, 383.29998779296875, 324.79998779296875, 269.75"
FINEORG,2,1,1,-248,-0.25,"4978.25, 4389.9501953125","4723.89990234375, 4435.89990234375"
FINOPB,1,1,0,1208,1.21,244.25,253.0500030517578
FINPIPE,5,2,3,6360,6.36,"6.340000152587891, 10.670000076293945, 126.33000183105469, 99.61000061035156, 152.0500030517578","9.149999618530273, 11.380000114440918, 105.04000091552734, 92.08999633789062, 136.60000610351562"
FIVESTAR,0,0,0,0,0.0,,
FLAIR,0,0,0,0,0.0,,
FLUOROCHEM,3,2,1,1965,1.96,"356.8999938964844, 3145.14990234375, 3046.60009765625","401.8999938964844, 3020.199951171875, 3049.949951171875"
FMGOETZE,3,0,3,-17066,-17.07,"180.0, 59.349998474121094, 405.75","102.6500015258789, 51.400001525878906, 388.8999938964844"
FORTIS,5,2,3,5422,5.42,"74.75, 97.69999694824219, 114.0, 160.4499969482422, 278.45001220703125","61.900001525878906, 95.1500015258789, 160.85000610351562, 139.0500030517578, 294.29998779296875"
FOSECOIND,3,2,1,5699,5.7,"248.5, 1539.050048828125, 1285.25","306.45001220703125, 1327.0, 1402.800048828125"
FSL,8,2,6,-22637,-22.64,"43.20000076293945, 15.449999809265137, 19.350000381469727, 12.649999618530273, 9.300000190734863, 43.849998474121094, 36.45000076293945, 109.9000015258789","28.649999618530273, 15.75, 17.450000762939453, 9.550000190734863, 9.399999618530273, 41.70000076293945, 38.099998474121094, 102.30000305175781"
FUSION,0,0,0,0,0.0,,
GABRIEL,4,3,1,35411,35.41,"4.125, 26.649999618530273, 23.700000762939453, 86.55000305175781","8.125, 26.524999618530273, 22.125, 85.25"
GAEL,3,2,1,10189,10.19,"4.550000190734863, 11.800000190734863, 40.92499923706055","6.512499809265137, 11.962499618530273, 35.29999923706055"
GAIL,7,5,2,6128,6.13,"66.01878356933594, 115.88333129882812, 89.66666412353516, 68.0999984741211, 68.43333435058594, 96.19999694824219, 94.75","66.34690856933594, 118.6500015258789, 91.56666564941406, 64.43333435058594, 82.16666412353516, 96.56666564941406, 96.05000305175781"
GALAXYSURF,2,0,2,-2810,-2.81,"1225.0999755859375, 2486.14990234375","1119.300048828125, 2464.550048828125"
GALLANTT,2,2,0,3561,3.56,"42.900001525878906, 29.100000381469727","44.650001525878906, 28.75"
GANDHAR,0,0,0,0,0.0,,
GANECOS,4,2,2,4228,4.23,"140.5, 397.70001220703125, 272.70001220703125, 222.4499969482422","157.10000610351562, 388.25, 260.0, 234.85000610351562"
GANESHHOUC,4,1,3,-11184,-11.18,"94.63333129882812, 41.93333435058594, 76.03333282470703, 36.599998474121094","80.53333282470703, 42.266666412353516, 79.0, 28.850000381469727"
GARFIBRES,4,2,2,16992,16.99,"40.25, 67.05000305175781, 3050.300048828125, 3031.85009765625","65.0, 63.400001525878906, 2972.300048828125, 3105.89990234375"
GATEWAY,0,0,0,0,0.0,,
GENESYS,3,0,3,-18552,-18.55,"10.050000190734863, 106.25, 43.70000076293945","8.75, 84.5, 28.75"
GENSOL,0,0,0,0,0.0,,
GENUSPOWER,6,3,3,44123,44.12,"9.774999618530273, 16.899999618530273, 16.25, 42.04999923706055, 23.350000381469727, 23.850000381469727","22.260000228881836, 16.549999237060547, 19.25, 39.75, 25.700000762939453, 21.899999618530273"
GEOJITFSL,7,4,3,24061,24.06,"35.400001525878906, 36.54999923706055, 26.399999618530273, 41.5, 28.049999237060547, 36.75, 65.75","41.20000076293945, 40.599998474121094, 47.150001525878906, 38.25, 29.049999237060547, 34.79999923706055, 50.099998474121094"
GEPIL,8,3,5,4681,4.68,"273.3999938964844, 615.5999755859375, 352.29998779296875, 420.5, 690.8499755859375, 579.9500122070312, 830.5999755859375, 177.0","349.79998779296875, 564.2000122070312, 338.8999938964844, 456.79998779296875, 640.4000244140625, 602.2000122070312, 816.4000244140625, 171.25"
GESHIP,7,5,2,15871,15.87,"205.35000610351562, 284.95001220703125, 252.8000030517578, 328.3500061035156, 304.79998779296875, 280.20001220703125, 314.04998779296875","283.1499938964844, 289.70001220703125, 289.45001220703125, 307.5, 287.70001220703125, 299.8999938964844, 325.3999938964844"
GET&D,5,2,3,-12200,-12.2,"195.1999969482422, 292.6499938964844, 190.10000610351562, 166.85000610351562, 126.75","182.85000610351562, 293.6000061035156, 205.4499969482422, 120.5, 103.69999694824219"
GHCL,6,3,3,7241,7.24,"150.60000610351562, 85.80000305175781, 29.450000762939453, 33.95000076293945, 245.3000030517578, 137.3000030517578","143.64999389648438, 55.099998474121094, 43.5, 33.400001525878906, 250.3000030517578, 138.3000030517578"
GICRE,5,1,4,8159,8.16,"219.89999389648438, 149.10000610351562, 140.9499969482422, 130.14999389648438, 124.0999984741211","311.1499938964844, 143.85000610351562, 139.10000610351562, 119.5, 122.94999694824219"
GILLETTE,3,2,1,-1602,-1.6,"820.5999755859375, 900.0499877929688, 5201.2998046875","869.75, 734.9000244140625, 5491.0"
GIPCL,5,2,3,-4836,-4.84,"60.349998474121094, 50.04999923706055, 65.6500015258789, 82.19999694824219, 72.9000015258789","61.04999923706055, 42.75, 68.75, 78.0, 69.30000305175781"
GLAND,2,1,1,175,0.17,"1358.800048828125, 1307.550048828125","924.0499877929688, 1741.449951171875"
GLAXO,5,2,3,833,0.83,"605.1749877929688, 1025.050048828125, 1657.0250244140625, 1444.25, 1336.25","616.25, 1084.0250244140625, 1618.199951171875, 1369.3499755859375, 1324.75"
GLENMARK,4,2,2,-1024,-1.02,"156.89999389648438, 697.0499877929688, 606.2000122070312, 337.29998779296875","178.60000610351562, 609.0999755859375, 544.5499877929688, 347.45001220703125"
GLOBUSSPR,7,1,6,-12161,-12.16,"99.25, 76.75, 184.1999969482422, 131.8000030517578, 127.9000015258789, 840.0999755859375, 873.4000244140625","106.1500015258789, 73.9000015258789, 146.6999969482422, 121.30000305175781, 124.94999694824219, 802.2000122070312, 812.0999755859375"
GLS,1,1,0,8672,8.67,392.8999938964844,504.29998779296875
GMDCLTD,8,7,1,35749,35.75,"34.349998474121094, 10.708999633789062, 52.5, 135.6999969482422, 103.4000015258789, 87.05000305175781, 65.4000015258789, 39.95000076293945","34.92499923706055, 13.41100025177002, 89.8499984741211, 139.75, 106.75, 84.75, 69.3499984741211, 41.0"
GMMPFAUDLR,2,1,1,-2533,-2.53,"1599.4000244140625, 1430.75","1660.699951171875, 1233.5999755859375"
GMRINFRA,6,3,3,621,0.62,"45.56473922729492, 25.898096084594727, 19.18050193786621, 11.351698875427246, 11.441790580749512, 17.072595596313477","38.97972869873047, 25.23517608642578, 19.489864349365234, 10.135444641113281, 14.324763298034668, 18.063615798950195"
GMRP&UI,0,0,0,0,0.0,,
GNFC,5,3,2,21603,21.6,"67.19999694824219, 107.75, 64.94999694824219, 61.150001525878906, 712.6500244140625","94.0, 102.4000015258789, 75.9000015258789, 76.1500015258789, 633.6500244140625"
GOCLCORP,4,3,1,21933,21.93,"32.724239349365234, 175.39999389648438, 311.6000061035156, 174.0","50.056121826171875, 203.5500030517578, 325.8999938964844, 154.60000610351562"
GOCOLORS,1,1,0,130,0.13,1074.0999755859375,1078.9000244140625
GODFRYPHLP,7,5,2,2483,2.48,"304.1400146484375, 283.0, 184.0, 629.25, 1188.449951171875, 797.2000122070312, 1024.699951171875","303.6499938964844, 285.8800048828125, 210.50999450683594, 580.4600219726562, 1207.3499755859375, 884.2000122070312, 960.9000244140625"
GODREJAGRO,2,2,0,4718,4.72,"477.0, 430.79998779296875","511.70001220703125, 459.1499938964844"
GODREJCP,2,0,2,-3810,-3.81,"810.6500244140625, 782.4000244140625","709.2999877929688, 766.9500122070312"
GODREJIND,9,3,6,32809,32.81,"73.49120330810547, 181.90447998046875, 599.5999755859375, 549.4500122070312, 536.4000244140625, 437.0, 318.6499938964844, 479.54998779296875, 462.45001220703125","139.5383758544922, 189.79815673828125, 596.7000122070312, 546.4500122070312, 514.3499755859375, 424.54998779296875, 417.5, 439.0, 429.8999938964844"
GODREJPROP,6,3,3,764,0.76,"213.85000610351562, 330.6499938964844, 663.2000122070312, 867.0999755859375, 1507.5999755859375, 1305.1500244140625","219.8000030517578, 364.1000061035156, 652.7000122070312, 926.5999755859375, 1407.699951171875, 1224.699951171875"
GOKEX,9,3,6,-5715,-5.72,"242.60000610351562, 100.75, 66.25, 36.20000076293945, 65.3499984741211, 102.80000305175781, 85.44999694824219, 88.19999694824219, 40.150001525878906","219.8000030517578, 107.9000015258789, 63.45000076293945, 46.5, 59.650001525878906, 91.25, 72.8499984741211, 85.3499984741211, 43.25"
GOKULAGRO,0,0,0,0,0.0,,
GOODLUCK,3,0,3,-7735,-7.73,"89.9000015258789, 78.8499984741211, 38.45000076293945","85.0999984741211, 63.150001525878906, 35.25"
GPIL,6,4,2,33203,33.2,"16.787500381469727, 19.575000762939453, 41.29999923706055, 41.98749923706055, 299.6499938964844, 295.3999938964844","28.575000762939453, 20.399999618530273, 57.98749923706055, 42.662498474121094, 319.3999938964844, 278.70001220703125"
GPPL,5,2,3,3020,3.02,"49.75, 152.89999389648438, 99.5, 60.79999923706055, 87.1500015258789","48.5, 165.10000610351562, 88.0999984741211, 75.8499984741211, 80.30000305175781"
GRANULES,5,2,3,2153,2.15,"10.645000457763672, 13.079999923706055, 102.8499984741211, 299.6499938964844, 300.3500061035156","10.524999618530273, 13.180000305175781, 115.6500015258789, 306.1000061035156, 281.95001220703125"
GRAPHITE,3,2,1,22138,22.14,"31.549999237060547, 393.6000061035156, 325.25","47.900001525878906, 373.3500061035156, 400.25"
GRASIM,10,6,4,2263,2.26,"181.4912872314453, 377.6722412109375, 188.22662353515625, 311.86968994140625, 445.6350402832031, 1063.272216796875, 854.5521240234375, 783.9329223632812, 586.8665161132812, 1566.7701416015625","200.6865997314453, 385.80401611328125, 184.515625, 342.5991516113281, 403.6645812988281, 1017.4544067382812, 897.630859375, 740.7047729492188, 617.2457275390625, 1672.001708984375"
GRAVITA,5,3,2,8434,8.43,"27.049999237060547, 36.650001525878906, 25.350000381469727, 81.1500015258789, 41.95000076293945","26.350000381469727, 36.25, 30.299999237060547, 85.5999984741211, 45.95000076293945"
GREAVESCOT,6,4,2,16080,16.08,"18.329999923706055, 86.25, 78.0, 137.10000610351562, 83.6500015258789, 83.9000015258789","28.0, 80.55000305175781, 77.4000015258789, 138.5, 81.30000305175781, 85.0999984741211"
GREENLAM,1,0,1,-3036,-3.04,157.3699951171875,141.11000061035156
GREENPANEL,1,0,1,-1297,-1.3,39.29999923706055,38.0
GREENPLY,4,4,0,33226,33.23,"2.990036964416504, 2.458651065826416, 14.59328556060791, 37.054256439208984","3.2755579948425293, 4.42160701751709, 15.99709701538086, 37.72245407104492"
GREENPOWER,4,2,2,13528,13.53,"12.982928276062012, 9.437944412231445, 12.062152862548828, 2.3019371032714844","12.246308326721191, 14.041818618774414, 13.535392761230469, 2.025705099105835"
GRINDWELL,0,0,0,0,0.0,,
GRINFRA,2,1,1,-2463,-2.46,"1361.25, 1259.9000244140625","1225.1500244140625, 1281.4000244140625"
GRSE,0,0,0,0,0.0,,
GRWRHITECH,0,0,0,0,0.0,,
GSFC,10,3,7,-13208,-13.21,"17.479999542236328, 79.9000015258789, 59.599998474121094, 56.75, 72.3499984741211, 133.4499969482422, 106.0999984741211, 104.25, 85.69999694824219, 53.45000076293945","15.75, 74.80000305175781, 57.20000076293945, 55.150001525878906, 73.30000305175781, 116.25, 116.19999694824219, 97.94999694824219, 60.79999923706055, 59.5"
GSPL,1,0,1,-932,-0.93,269.5,263.70001220703125
GTLINFRA,3,1,2,-6178,-6.18,"25.001182556152344, 45.75, 12.0","29.13747215270996, 30.450000762939453, 11.949999809265137"
GUFICBIO,6,4,2,27975,27.98,"11.0, 4.5, 7.25, 5.099999904632568, 69.5999984741211, 217.25","12.300000190734863, 7.599999904632568, 6.949999809265137, 5.5, 73.19999694824219, 220.8000030517578"
GUJALKALI,7,5,2,14237,14.24,"147.9499969482422, 180.5500030517578, 75.69999694824219, 576.4500122070312, 455.79998779296875, 888.9000244140625, 684.4500122070312","149.10000610351562, 197.14999389648438, 104.3499984741211, 596.6500244140625, 466.3500061035156, 848.6500244140625, 648.5499877929688"
GUJGASLTD,4,2,2,-4841,-4.84,"134.00999450683594, 559.2999877929688, 471.75, 433.1499938964844","127.55000305175781, 418.8500061035156, 503.25, 461.5"
GULFOILLUB,1,0,1,-2046,-2.05,888.0499877929688,819.75
HAL,1,1,0,3717,3.72,386.07501220703125,436.2250061035156
HAPPSTMNDS,1,1,0,1808,1.81,920.5,978.5
HAPPYFORGE,0,0,0,0,0.0,,
HARSHA,1,0,1,-276,-0.28,429.5,425.8500061035156
HATHWAY,8,3,5,63,0.06,"41.040000915527344, 24.670000076293945, 30.850000381469727, 42.79999923706055, 23.399999618530273, 20.100000381469727, 17.950000762939453, 17.149999618530273","40.81999969482422, 22.200000762939453, 34.29999923706055, 39.900001525878906, 30.049999237060547, 18.100000381469727, 16.149999618530273, 17.299999237060547"
HATSUN,3,2,1,1152,1.15,"488.8337097167969, 975.1884765625, 881.2000122070312","485.2629089355469, 1013.7189331054688, 921.5999755859375"
HAVELLS,5,2,3,-725,-0.73,"14.4350004196167, 74.13999938964844, 420.04998779296875, 718.2999877929688, 1311.800048828125","15.100000381469727, 79.4000015258789, 406.1000061035156, 691.8499755859375, 1201.800048828125"
HBLPOWER,4,1,3,9136,9.14,"14.130000114440918, 44.79999923706055, 19.0, 15.949999809265137","22.15999984741211, 40.0, 16.100000381469727, 14.649999618530273"
HCC,9,5,4,33127,33.13,"55.2651252746582, 24.98593521118164, 60.04250717163086, 21.173002243041992, 23.72991180419922, 18.750667572021484, 12.739686965942383, 10.050000190734863, 5.949999809265137","62.35269546508789, 53.022220611572266, 50.510169982910156, 25.6588077545166, 24.402782440185547, 16.732053756713867, 9.554764747619629, 11.600000381469727, 5.550000190734863"
HCG,2,1,1,5156,5.16,"115.80000305175781, 100.44999694824219","111.0999984741211, 122.80000305175781"
HCLTECH,5,5,0,19306,19.31,"64.98249816894531, 32.525001525878906, 109.4124984741211, 389.2749938964844, 1041.1500244140625","72.69999694824219, 41.724998474121094, 121.23750305175781, 399.95001220703125, 1120.800048828125"
HDFCAMC,3,3,0,9759,9.76,"1533.9000244140625, 1947.300048828125, 1963.050048828125","1695.050048828125, 2074.89990234375, 2295.64990234375"
HDFCBANK,5,4,1,9035,9.03,"85.20500183105469, 97.33999633789062, 643.3250122070312, 1065.8499755859375, 1520.0999755859375","92.53500366210938, 110.03500366210938, 695.0499877929688, 1032.800048828125, 1531.550048828125"
HDFCLIFE,6,4,2,6748,6.75,"396.70001220703125, 378.5, 523.2000122070312, 582.4000244140625, 590.5999755859375, 529.75","387.1499938964844, 404.54998779296875, 549.0, 598.9500122070312, 566.25, 592.3499755859375"
HEG,8,7,1,33389,33.39,"132.39999389648438, 120.0, 213.35000610351562, 191.60000610351562, 163.60000610351562, 175.6999969482422, 1132.1500244140625, 1176.050048828125","134.35000610351562, 181.0, 223.64999389648438, 240.89999389648438, 164.25, 210.85000610351562, 1065.949951171875, 1266.800048828125"
HEIDELBERG,6,4,2,10389,10.39,"44.599998474121094, 33.95000076293945, 33.099998474121094, 47.45000076293945, 177.10000610351562, 190.75","54.29999923706055, 39.04999923706055, 35.349998474121094, 42.29999923706055, 185.14999389648438, 189.4499969482422"
HEMIPROP,0,0,0,0,0.0,,
HERITGFOOD,7,4,3,2496,2.5,"9.032938957214355, 22.921478271484375, 29.621700286865234, 194.0465545654297, 183.904296875, 165.0143585205078, 169.14999389648438","9.990113258361816, 22.617210388183594, 24.956266403198242, 151.80409240722656, 187.63157653808594, 169.933349609375, 215.75"
HEROMOTOCO,9,4,5,-4346,-4.35,"774.9000244140625, 732.4000244140625, 1710.0, 1736.3499755859375, 2581.39990234375, 3055.199951171875, 2501.85009765625, 2724.300048828125, 2558.60009765625","757.9000244140625, 692.5999755859375, 1854.75, 1663.050048828125, 2699.14990234375, 3104.25, 2051.75, 2535.449951171875, 2759.89990234375"
HFCL,5,2,3,4171,4.17,"10.149999618530273, 12.100000381469727, 13.25, 13.899999618530273, 15.899999618530273","8.149999618530273, 19.649999618530273, 13.25, 14.100000381469727, 12.5"
HGINFRA,1,0,1,-2679,-2.68,204.5500030517578,182.75
HGS,10,4,6,9774,9.77,"2387.0, 215.25, 204.89999389648438, 161.1999969482422, 142.52499389648438, 235.47500610351562, 313.6499938964844, 327.1000061035156, 1067.0999755859375, 1128.6500244140625","2190.60009765625, 285.5, 178.77499389648438, 152.3000030517578, 138.1750030517578, 246.4499969482422, 291.04998779296875, 404.79998779296875, 1312.199951171875, 1079.5999755859375"
HIKAL,6,2,4,12198,12.2,"56.18000030517578, 62.56666564941406, 24.133333206176758, 123.75, 342.70001220703125, 303.95001220703125","52.0533332824707, 51.79999923706055, 37.49333190917969, 129.75, 335.95001220703125, 299.8500061035156"
HIL,9,2,7,-17350,-17.35,"207.85000610351562, 172.4499969482422, 383.8999938964844, 339.8500061035156, 294.70001220703125, 1393.949951171875, 927.3499755859375, 3698.050048828125, 2703.10009765625","185.8000030517578, 168.14999389648438, 363.70001220703125, 308.1000061035156, 261.8999938964844, 1049.699951171875, 1165.050048828125, 2843.64990234375, 2812.699951171875"
HINDALCO,12,5,7,-3825,-3.82,"107.43659210205078, 52.04999923706055, 160.35000610351562, 102.4000015258789, 141.75, 84.05000305175781, 84.75, 87.94999694824219, 191.35000610351562, 138.85000610351562, 439.0, 436.1000061035156","122.01256561279297, 53.75, 166.39999389648438, 99.80000305175781, 134.3000030517578, 77.05000305175781, 70.5, 96.3499984741211, 187.89999389648438, 146.1999969482422, 390.54998779296875, 405.8999938964844"
HINDCOPPER,7,4,3,5050,5.05,"310.54998779296875, 68.6500015258789, 48.95000076293945, 35.20000076293945, 31.700000762939453, 118.75, 113.25","294.70001220703125, 74.0999984741211, 46.04999923706055, 41.400001525878906, 35.45000076293945, 106.94999694824219, 116.05000305175781"
HINDOILEXP,8,4,4,26517,26.52,"110.35426330566406, 89.1771240234375, 145.0, 78.5, 200.75, 50.400001525878906, 103.1500015258789, 50.79999923706055","109.72283172607422, 109.25654602050781, 135.85000610351562, 144.25, 210.3000030517578, 36.79999923706055, 74.75, 65.6500015258789"
HINDPETRO,9,6,3,11390,11.39,"61.70000076293945, 80.81111145019531, 82.82221984863281, 69.68888854980469, 73.03333282470703, 47.766666412353516, 301.70001220703125, 209.35000610351562, 239.10000610351562","62.155555725097656, 104.33333587646484, 84.55555725097656, 67.46666717529297, 64.38888549804688, 52.733333587646484, 325.25, 217.89999389648438, 235.14999389648438"
HINDUNILVR,3,2,1,681,0.68,"583.7999877929688, 862.75, 2234.85009765625","592.5, 816.9000244140625, 2353.25"
HINDWAREAP,3,0,3,-7178,-7.18,"78.0999984741211, 86.80000305175781, 346.29998779296875","74.4000015258789, 82.55000305175781, 325.3999938964844"
HINDZINC,7,3,4,-3943,-3.94,"94.98999786376953, 45.1150016784668, 104.63500213623047, 123.75, 157.14999389648438, 299.54998779296875, 278.6499938964844","82.63999938964844, 48.084999084472656, 107.88500213623047, 133.5500030517578, 143.60000610351562, 289.29998779296875, 260.20001220703125"
HITECH,2,0,2,-7723,-7.72,"18.940000534057617, 10.760000228881836","14.949999809265137, 11.145000457763672"
HLEGLAS,2,1,1,253,0.25,"708.3599853515625, 594.3499755859375","692.969970703125, 617.75"
HMAAGRO,0,0,0,0,0.0,,
HMT,3,1,2,-557,-0.56,"43.900001525878906, 21.0, 19.0","45.599998474121094, 20.950000762939453, 18.299999237060547"
HNDFDS,0,0,0,0,0.0,,
HOMEFIRST,0,0,0,0,0.0,,
HONASA,0,0,0,0,0.0,,
HONAUT,4,4,0,22934,22.93,"1322.5, 970.0, 2323.5, 8971.5498046875","1516.0999755859375, 1339.699951171875, 2793.39990234375, 9478.099609375"
HONDAPOWER,7,4,3,3382,3.38,"244.3000030517578, 153.35000610351562, 414.1000061035156, 386.20001220703125, 1338.4000244140625, 1100.050048828125, 966.0499877929688","207.75, 182.89999389648438, 411.20001220703125, 455.3999938964844, 1118.5, 1055.4000244140625, 1017.4000244140625"
HPL,2,0,2,-10457,-10.46,"42.29999923706055, 33.20000076293945","33.75, 29.649999618530273"
HSCL,3,1,2,18096,18.1,"11.199999809265137, 17.049999237060547, 18.299999237060547","20.155000686645508, 14.550000190734863, 15.899999618530273"
HUDCO,1,0,1,-1079,-1.08,34.75,33.70000076293945
HUHTAMAKI,4,2,2,1445,1.44,"66.6500015258789, 258.0, 197.75, 195.5500030517578","71.11000061035156, 304.75, 168.85000610351562, 188.60000610351562"
IBREALEST,12,8,4,37204,37.2,"334.0749206542969, 112.66175842285156, 142.2935791015625, 107.96932983398438, 71.05000305175781, 54.5, 81.9000015258789, 63.0, 75.4000015258789, 92.19999694824219, 68.05000305175781, 86.94999694824219","363.489501953125, 215.4172821044922, 145.421875, 112.42516326904297, 74.5999984741211, 62.20000076293945, 68.9000015258789, 61.849998474121094, 80.5999984741211, 115.05000305175781, 65.3499984741211, 77.75"
IBULHSGFIN,5,2,3,-5236,-5.24,"765.0318603515625, 184.6505584716797, 166.73370361328125, 121.85243225097656, 102.64307403564453","619.9142456054688, 169.36329650878906, 196.37228393554688, 105.85205841064453, 109.99700164794922"
ICICIBANK,4,1,3,10761,10.76,"87.45454406738281, 169.3000030517578, 164.0272674560547, 215.13636779785156","134.57272338867188, 129.53636169433594, 164.7818145751953, 215.40908813476562"
ICICIGI,1,1,0,661,0.66,1211.1500244140625,1236.800048828125
ICICIPRULI,2,2,0,1771,1.77,"425.79998779296875, 525.75","452.25, 521.5999755859375"
ICIL,6,3,3,25536,25.54,"1.0299999713897705, 81.55000305175781, 48.70000076293945, 41.0, 37.150001525878906, 164.39999389648438","1.3600000143051147, 79.0999984741211, 41.25, 44.29999923706055, 65.0, 136.0500030517578"
ICRA,3,0,3,-2307,-2.31,"431.54998779296875, 3992.300048828125, 3725.75","440.5, 3937.64990234375, 3439.75"
IDBI,12,5,7,6169,6.17,"65.19999694824219, 83.75, 63.599998474121094, 117.0, 101.4000015258789, 100.05000305175781, 65.30000305175781, 72.4000015258789, 69.4000015258789, 62.70000076293945, 31.75, 44.099998474121094","82.94999694824219, 74.3499984741211, 92.9000015258789, 92.94999694824219, 108.0999984741211, 92.80000305175781, 68.19999694824219, 73.1500015258789, 69.3499984741211, 50.20000076293945, 33.20000076293945, 38.70000076293945"
IDEA,5,2,3,-2036,-2.04,"35.002349853515625, 71.48197937011719, 66.38688659667969, 55.744483947753906, 9.949999809265137","35.24353790283203, 69.31128692626953, 69.85395812988281, 54.659141540527344, 8.25"
IDEAFORGE,0,0,0,0,0.0,,
IDFC,13,6,7,14267,14.27,"29.274948120117188, 37.429935455322266, 75.49469757080078, 64.7027587890625, 51.64012908935547, 44.599998474121094, 58.70000076293945, 52.650001525878906, 43.599998474121094, 46.54999923706055, 35.599998474121094, 18.399999618530273, 54.650001525878906","32.98619842529297, 60.82059860229492, 70.95329284667969, 53.08068084716797, 50.761146545410156, 51.54999923706055, 50.650001525878906, 39.75, 39.599998474121094, 40.150001525878906, 39.25, 19.0, 68.6500015258789"
IDFCFIRSTB,3,2,1,1319,1.32,"47.599998474121094, 25.700000762939453, 37.54999923706055","36.29999923706055, 26.600000381469727, 49.150001525878906"
IEX,2,0,2,-4682,-4.68,"147.85000610351562, 144.5500030517578","140.0, 127.94999694824219"
IFBIND,5,2,3,221,0.22,"138.89999389648438, 79.0, 69.55000305175781, 977.9500122070312, 415.1000061035156","137.75, 81.0999984741211, 80.05000305175781, 905.2000122070312, 371.1499938964844"
IFCI,9,5,4,52167,52.17,"11.350000381469727, 12.0, 9.399999618530273, 25.200000762939453, 28.700000762939453, 26.649999618530273, 27.049999237060547, 4.75, 11.0","10.949999809265137, 11.100000381469727, 9.899999618530273, 46.900001525878906, 43.79999923706055, 28.149999618530273, 23.899999618530273, 7.5, 9.550000190734863"
IFGLEXPOR,10,4,6,8227,8.23,"62.400001525878906, 20.899999618530273, 36.95000076293945, 123.75, 102.44999694824219, 161.9499969482422, 156.75, 133.1999969482422, 240.25, 682.0999755859375","68.75, 28.049999237060547, 32.599998474121094, 117.55000305175781, 116.25, 156.25, 142.1999969482422, 107.75, 293.8500061035156, 607.4000244140625"
IGL,6,2,4,-14191,-14.19,"23.729999542236328, 23.6200008392334, 21.559999465942383, 75.87999725341797, 47.880001068115234, 418.3500061035156","23.489999771118164, 24.200000762939453, 20.459999084472656, 43.70000076293945, 46.709999084472656, 430.3999938964844"
IIFL,6,2,4,-4851,-4.85,"18.04025650024414, 31.70695686340332, 37.599639892578125, 33.193641662597656, 402.1560974121094, 81.6500015258789","20.08377456665039, 41.00550079345703, 36.16701126098633, 27.895633697509766, 282.8219299316406, 79.55000305175781"
IIFLSEC,0,0,0,0,0.0,,
IKIO,0,0,0,0,0.0,,
IMAGICAA,4,2,2,-836,-0.84,"136.4499969482422, 86.1500015258789, 4.199999809265137, 4.800000190734863","102.75, 78.5, 4.400000095367432, 6.0"
IMFA,5,3,2,-4494,-4.49,"74.8499984741211, 129.375, 89.7249984741211, 72.2750015258789, 263.6000061035156","60.0, 119.0250015258789, 91.55000305175781, 79.42500305175781, 286.95001220703125"
INDHOTEL,7,5,2,15545,15.55,"44.92085266113281, 59.712974548339844, 43.51424026489258, 89.97782897949219, 98.05451202392578, 133.08729553222656, 154.953369140625","59.304603576660156, 62.9345703125, 44.603233337402344, 85.03199768066406, 113.8448715209961, 132.74790954589844, 147.3899383544922"
INDIACEM,9,4,5,441,0.44,"97.69999694824219, 123.30000305175781, 60.150001525878906, 107.5, 145.6999969482422, 126.4000015258789, 108.30000305175781, 196.85000610351562, 202.35000610351562","102.0, 111.9000015258789, 60.150001525878906, 100.4000015258789, 170.10000610351562, 101.19999694824219, 107.0999984741211, 228.4499969482422, 212.10000610351562"
INDIAGLYCO,9,4,5,25618,25.62,"154.64999389648438, 138.14999389648438, 313.04998779296875, 55.0, 100.55000305175781, 94.6500015258789, 278.6499938964844, 227.85000610351562, 622.5","142.6999969482422, 144.3000030517578, 295.8500061035156, 102.8499984741211, 88.9000015258789, 108.5, 253.5500030517578, 227.5, 611.9000244140625"
INDIAMART,3,1,2,-3985,-3.99,"2457.375, 2205.02490234375, 2721.89990234375","2277.25, 2228.925048828125, 2521.35009765625"
INDIANB,8,5,3,15154,15.15,"126.75, 101.5999984741211, 232.75, 101.0999984741211, 103.9000015258789, 141.1999969482422, 280.1000061035156, 62.0","129.1999969482422, 137.1999969482422, 241.10000610351562, 116.1500015258789, 97.5, 157.9499969482422, 252.3000030517578, 58.45000076293945"
INDIANHUME,5,1,4,-25220,-25.22,"70.55000305175781, 57.15999984741211, 288.8999938964844, 256.1499938964844, 175.39999389648438","52.91999816894531, 39.91999816894531, 293.45001220703125, 182.0, 160.39999389648438"
INDIASHLTR,0,0,0,0,0.0,,
INDIGO,5,5,0,10643,10.64,"1075.949951171875, 903.0, 1051.4000244140625, 1038.25, 2020.949951171875","1064.300048828125, 856.9000244140625, 1105.8499755859375, 1165.050048828125, 2372.5"
INDIGOPNTS,2,1,1,5129,5.13,"1679.25, 1153.550048828125","1499.4000244140625, 1456.25"
INDOCO,6,2,4,-6399,-6.4,"41.959999084472656, 41.779998779296875, 39.45333480834961, 19.333332061767578, 202.3000030517578, 352.1499938964844","41.91999816894531, 37.29999923706055, 39.91999816894531, 19.34000015258789, 199.6999969482422, 326.95001220703125"
INDOSTAR,3,1,2,-3869,-3.87,"343.20001220703125, 281.54998779296875, 181.8000030517578","346.70001220703125, 278.54998779296875, 155.64999389648438"
INDRAMEDCO,2,0,2,-7528,-7.53,"55.150001525878906, 49.099998474121094","52.5, 39.849998474121094"
INDUSINDBK,6,3,3,17355,17.36,"56.150001525878906, 43.29999923706055, 40.75, 1252.050048828125, 1780.0, 630.2000122070312","46.04999923706055, 50.54999923706055, 71.44999694824219, 1312.5999755859375, 1606.5, 527.4000244140625"
INDUSTOWER,3,1,2,-3569,-3.57,"156.39999389648438, 229.9499969482422, 308.70001220703125","164.85000610351562, 221.5, 271.5"
INFIBEAM,3,1,2,-2236,-2.24,"8.95998477935791, 15.899999618530273, 15.050000190734863","8.688787460327148, 14.699999809265137, 15.75"
INFY,7,4,3,7599,7.6,"206.94375610351562, 219.1374969482422, 163.3312530517578, 359.6937561035156, 312.35626220703125, 505.29998779296875, 1335.5","225.8000030517578, 245.35000610351562, 153.90625, 325.85626220703125, 371.20623779296875, 464.29998779296875, 1355.699951171875"
INGERRAND,6,2,4,-3877,-3.88,"266.54998779296875, 323.25, 309.45001220703125, 690.0499877929688, 597.0499877929688, 644.9000244140625","277.1499938964844, 323.25, 284.8999938964844, 680.4500122070312, 549.2000122070312, 655.2999877929688"
INNOVACAP,0,0,0,0,0.0,,
INOXGREEN,1,1,0,6079,6.08,48.79999923706055,58.599998474121094
INOXINDIA,0,0,0,0,0.0,,
INOXWIND,3,1,2,1740,1.74,"25.274999618530273, 9.962499618530273, 27.9375","21.6875, 8.649999618530273, 36.900001525878906"
INTELLECT,4,2,2,6226,6.23,"121.68504333496094, 203.35000610351562, 170.1999969482422, 111.6500015258789","117.51646423339844, 227.3000030517578, 115.6500015258789, 159.85000610351562"
IOB,9,6,3,17970,17.97,"89.94999694824219, 63.400001525878906, 44.20000076293945, 50.849998474121094, 30.25, 25.850000381469727, 15.600000381469727, 12.199999809265137, 10.949999809265137","91.80000305175781, 91.19999694824219, 51.0, 61.849998474121094, 31.299999237060547, 26.799999237060547, 13.100000381469727, 10.350000381469727, 10.699999809265137"
IOC,7,6,1,10820,10.82,"41.287498474121094, 36.75416564941406, 48.133331298828125, 96.4000015258789, 56.900001525878906, 56.400001525878906, 76.6500015258789","43.541664123535156, 38.849998474121094, 47.29999923706055, 108.56666564941406, 58.96666717529297, 60.633331298828125, 76.5"
IOLCP,2,0,2,-8842,-8.84,"22.950000762939453, 68.9000015258789","18.049999237060547, 64.30000305175781"
IONEXCHANG,0,0,0,0,0.0,,
IPCALAB,6,4,2,13312,13.31,"40.20000076293945, 395.9750061035156, 257.875, 398.2250061035156, 1000.25, 742.8499755859375","56.83000183105469, 365.6499938964844, 270.6000061035156, 401.04998779296875, 905.2000122070312, 873.5"
IPL,1,0,1,-2343,-2.34,295.95001220703125,283.95001220703125
IRB,8,3,5,-12724,-12.72,"12.9399995803833, 21.204999923706055, 15.204999923706055, 10.329999923706055, 24.604999542236328, 23.139999389648438, 14.925000190734863, 10.654999732971191","11.255000114440918, 17.575000762939453, 12.204999923706055, 11.475000381469727, 25.545000076293945, 23.174999237060547, 16.415000915527344, 8.399999618530273"
IRCON,2,1,1,3162,3.16,"37.540000915527344, 40.849998474121094","42.92499923706055, 39.5"
IRCTC,2,0,2,-702,-0.7,"710.75, 649.5","706.0, 635.0999755859375"
IREDA,0,0,0,0,0.0,,
IRFC,2,0,2,-1697,-1.7,"24.200000762939453, 21.399999618530273","23.25, 21.25"
ISEC,2,1,1,-1574,-1.57,"242.0, 480.54998779296875","221.64999389648438, 501.54998779296875"
ISGEC,1,0,1,-938,-0.94,506.0,490.1000061035156
ISMTLTD,6,1,5,-17162,-17.16,"49.349998474121094, 29.600000381469727, 11.699999809265137, 10.600000381469727, 9.800000190734863, 6.849999904632568","49.599998474121094, 29.049999237060547, 9.399999618530273, 10.449999809265137, 8.199999809265137, 6.349999904632568"
ITC,3,2,1,1803,1.8,"216.73333740234375, 197.35000610351562, 193.64999389648438","218.43333435058594, 194.64999389648438, 209.0"
ITDC,3,2,1,15556,15.56,"230.89999389648438, 209.4499969482422, 392.0","372.04998779296875, 212.9499969482422, 350.0"
ITDCEM,6,2,4,15063,15.06,"10.305000305175781, 16.920000076293945, 15.739999771118164, 15.28499984741211, 64.75, 49.5","17.56999969482422, 14.550000190734863, 13.774999618530273, 16.799999237060547, 55.400001525878906, 45.25"
ITI,4,1,3,3033,3.03,"56.04999923706055, 49.45000076293945, 23.399999618530273, 94.8499984741211","55.650001525878906, 44.75, 28.149999618530273, 93.80000305175781"
IWEL,0,0,0,0,0.0,,
J&KBANK,5,1,4,-6867,-6.87,"42.939998626708984, 81.0999984741211, 41.0, 18.100000381469727, 31.75","44.90999984741211, 81.69999694824219, 38.5, 15.800000190734863, 27.700000762939453"
JAGRAN,8,4,4,-6476,-6.48,"46.641998291015625, 73.80000305175781, 59.70000076293945, 107.0, 125.94999694824219, 62.650001525878906, 39.75, 63.25","48.32400131225586, 70.75, 44.099998474121094, 100.94999694824219, 113.30000305175781, 68.25, 42.650001525878906, 64.94999694824219"
JAIBALAJI,5,2,3,15899,15.9,"84.80000305175781, 98.19999694824219, 215.1999969482422, 37.0, 22.899999618530273","69.19999694824219, 168.35000610351562, 264.20001220703125, 35.150001525878906, 18.600000381469727"
JAICORPLTD,4,3,1,21648,21.65,"16.054000854492188, 166.75, 60.04999923706055, 115.55000305175781","18.840999603271484, 274.54998779296875, 49.95000076293945, 116.6500015258789"
JAMNAAUTO,4,2,2,-1361,-1.36,"10.114999771118164, 5.900000095367432, 62.79999923706055, 32.5","10.545000076293945, 7.039999961853027, 54.650001525878906, 28.5"
JASH,4,2,2,6704,6.7,"137.9499969482422, 98.6500015258789, 102.5999984741211, 175.0","118.75, 121.5, 120.05000305175781, 141.6999969482422"
JAYNECOIND,8,3,5,16375,16.37,"19.100000381469727, 14.75, 13.550000190734863, 12.800000190734863, 7.300000190734863, 12.600000381469727, 5.650000095367432, 4.699999809265137","15.300000190734863, 14.100000381469727, 18.100000381469727, 20.649999618530273, 8.899999618530273, 11.100000381469727, 4.800000190734863, 3.700000047683716"
JBCHEPHARM,3,0,3,-7201,-7.2,"34.400001525878906, 170.4250030517578, 859.4500122070312","33.17499923706055, 146.39999389648438, 812.8250122070312"
JBMA,5,1,4,1014,1.01,"1.493265986442566, 6.335000038146973, 61.81999969482422, 75.04000091552734, 87.73999786376953","1.3617329597473145, 6.300000190734863, 57.81999969482422, 90.36000061035156, 75.4000015258789"
JCHAC,4,3,1,21422,21.42,"49.650001525878906, 220.60000610351562, 130.75, 1850.300048828125","75.80000305175781, 220.25, 124.5, 2125.64990234375"
JINDALPOLY,9,2,7,10613,10.61,"134.2834930419922, 73.46923828125, 80.19512939453125, 69.46182250976562, 216.44717407226562, 199.6676025390625, 256.66192626953125, 231.9612579345703, 625.2000122070312","129.54959106445312, 71.96939086914062, 70.89137268066406, 133.0883026123047, 157.01559448242188, 177.82601928710938, 252.39671325683594, 218.13450622558594, 678.25"
JINDALSAW,11,4,7,9793,9.79,"58.119998931884766, 42.0, 209.60000610351562, 152.25, 143.25, 131.89999389648438, 76.3499984741211, 53.20000076293945, 93.0999984741211, 85.75, 57.900001525878906","64.25, 73.2300033569336, 198.35000610351562, 122.0, 161.89999389648438, 128.5500030517578, 66.25, 51.150001525878906, 73.3499984741211, 88.69999694824219, 54.70000076293945"
JINDALSTEL,8,7,1,40422,40.42,"33.85499954223633, 151.875, 447.8500061035156, 158.64999389648438, 80.1500015258789, 116.25, 121.55000305175781, 389.04998779296875","38.99833297729492, 172.125, 420.20001220703125, 193.85000610351562, 90.9000015258789, 161.0, 161.5, 433.3500061035156"
JINDWORLD,4,2,2,1421,1.42,"11.600000381469727, 9.664999961853027, 47.54999923706055, 268.79998779296875","13.494999885559082, 8.149999618530273, 44.5, 317.75"
JIOFIN,0,0,0,0,0.0,,
JISLDVREQS,4,1,3,-11135,-11.14,"33.900001525878906, 42.75, 56.599998474121094, 6.949999809265137","25.600000381469727, 42.650001525878906, 42.599998474121094, 7.699999809265137"
JISLJALEQS,7,3,4,-4584,-4.58,"47.82857131958008, 65.73332977294922, 75.0, 69.19999694824219, 61.099998474121094, 7.0, 40.79999923706055","52.56190490722656, 64.38095092773438, 74.5999984741211, 52.0, 64.55000305175781, 7.550000190734863, 36.900001525878906"
JITFINFRA,3,0,3,-21624,-21.62,"24.049999237060547, 7.800000190734863, 8.800000190734863","17.600000381469727, 6.900000095367432, 6.5"
JKCEMENT,7,4,3,21933,21.93,"170.10000610351562, 58.900001525878906, 187.5500030517578, 240.0, 675.5, 886.0, 2504.14990234375","197.89999389648438, 89.80000305175781, 193.35000610351562, 227.0500030517578, 593.25, 934.9500122070312, 2716.550048828125"
JKIL,4,2,2,1350,1.35,"90.4000015258789, 214.0, 137.0, 95.80000305175781","88.1500015258789, 193.5500030517578, 160.64999389648438, 95.9000015258789"
JKLAKSHMI,10,6,4,-4007,-4.01,"59.474998474121094, 50.900001525878906, 107.25, 71.0, 79.25, 339.70001220703125, 410.8999938964844, 293.0, 356.8500061035156, 241.6999969482422","62.875, 51.099998474121094, 96.75, 67.75, 66.4000015258789, 349.8999938964844, 460.95001220703125, 298.04998779296875, 307.8999938964844, 252.9499969482422"
JKPAPER,7,3,4,11045,11.04,"45.99714660644531, 17.37457275390625, 35.04999923706055, 30.350000381469727, 141.85000610351562, 150.0, 364.75","45.75782775878906, 26.70802116394043, 34.5, 27.299999237060547, 138.25, 121.5, 392.95001220703125"
JKTYRE,5,3,2,11038,11.04,"22.56999969482422, 10.600000381469727, 15.170000076293945, 111.0999984741211, 128.39999389648438","26.8700008392334, 14.069999694824219, 15.960000038146973, 90.8499984741211, 115.4000015258789"
JLHL,0,0,0,0,0.0,,
JMFINANCIL,6,2,4,-12277,-12.28,"28.600000381469727, 93.8499984741211, 94.0999984741211, 79.25, 70.0, 76.8499984741211","25.149999618530273, 77.3499984741211, 88.5, 78.0, 74.69999694824219, 65.55000305175781"
JPASSOCIAT,11,6,5,34355,34.36,"181.13333129882812, 56.06666564941406, 92.80000305175781, 72.75, 53.70000076293945, 13.5, 8.850000381469727, 11.399999618530273, 7.699999809265137, 8.25, 7.949999809265137","142.13333129882812, 92.56666564941406, 92.5999984741211, 77.44999694824219, 53.849998474121094, 12.899999618530273, 12.100000381469727, 16.450000762939453, 6.5, 8.399999618530273, 7.75"
JPPOWER,7,5,2,36327,36.33,"38.20000076293945, 48.150001525878906, 38.54999923706055, 15.300000190734863, 4.949999809265137, 4.349999904632568, 1.5499999523162842","70.3499984741211, 49.20000076293945, 33.900001525878906, 18.549999237060547, 6.150000095367432, 2.4000000953674316, 2.299999952316284"
JSL,7,5,2,27231,27.23,"114.3499984741211, 60.0, 89.30000305175781, 42.349998474121094, 35.25, 35.400001525878906, 118.8499984741211","120.0999984741211, 95.0, 108.6500015258789, 33.45000076293945, 40.599998474121094, 34.650001525878906, 128.0"
JSWENERGY,5,1,4,-8223,-8.22,"43.900001525878906, 94.19999694824219, 72.9000015258789, 47.150001525878906, 341.04998779296875","46.54999923706055, 93.30000305175781, 61.25, 45.900001525878906, 300.3500061035156"
JSWHL,5,3,2,25891,25.89,"256.5, 1140.0999755859375, 615.5499877929688, 1921.449951171875, 3614.550048828125","373.54998779296875, 1075.0999755859375, 875.25, 1770.449951171875, 4261.60009765625"
JSWINFRA,0,0,0,0,0.0,,
JSWSTEEL,9,6,3,24743,24.74,"22.94499969482422, 30.285001754760742, 34.25, 72.96500396728516, 308.3500061035156, 261.54998779296875, 189.35000610351562, 629.5999755859375, 725.2999877929688","19.604999542236328, 34.880001068115234, 55.31500244140625, 86.14500427246094, 271.70001220703125, 270.04998779296875, 220.25, 666.9000244140625, 696.2999877929688"
JTEKTINDIA,8,3,5,12869,12.87,"26.924999237060547, 9.199999809265137, 10.949999809265137, 50.599998474121094, 85.75, 66.8499984741211, 80.05000305175781, 123.9000015258789","24.575000762939453, 13.550000190734863, 10.899999618530273, 44.70000076293945, 92.1500015258789, 61.95000076293945, 73.69999694824219, 142.75"
JTLIND,0,0,0,0,0.0,,
JUBLFOOD,3,3,0,8877,8.88,"101.07499694824219, 271.8800048828125, 483.29998779296875","110.73500061035156, 320.17999267578125, 501.25"
JUBLINDS,2,2,0,5730,5.73,"161.5500030517578, 40.25","166.3000030517578, 49.5"
JUBLINGREA,1,0,1,-4594,-4.59,508.6000061035156,437.79998779296875
JUBLPHARMA,9,7,2,41118,41.12,"82.61972045898438, 145.3224334716797, 75.11890411376953, 129.6007537841797, 403.5483703613281, 379.0840759277344, 471.6499938964844, 367.04998779296875, 330.1000061035156","122.89325714111328, 160.0685577392578, 104.42353057861328, 119.31974029541016, 460.99444580078125, 414.5047912597656, 384.25, 391.54998779296875, 398.54998779296875"
JUSTDIAL,3,2,1,2694,2.69,"1268.9000244140625, 766.4000244140625, 817.0499877929688","1079.800048828125, 846.4500122070312, 906.2000122070312"
JWL,6,2,4,1512,1.51,"43.95000076293945, 42.95000076293945, 41.04999923706055, 10.699999809265137, 18.450000762939453, 12.75","37.849998474121094, 34.79999923706055, 45.349998474121094, 10.800000190734863, 23.649999618530273, 11.949999809265137"
JYOTHYLAB,4,3,1,-7076,-7.08,"18.762500762939453, 40.32500076293945, 117.5, 147.4499969482422","12.975000381469727, 41.01250076293945, 123.19999694824219, 154.3000030517578"
JYOTICNC,0,0,0,0,0.0,,
JYOTISTRUC,9,5,4,42488,42.49,"89.30000305175781, 76.05000305175781, 77.5, 19.799999237060547, 12.800000190734863, 10.100000381469727, 2.5999999046325684, 1.899999976158142, 9.100000381469727","114.6500015258789, 61.650001525878906, 144.64999389648438, 23.899999618530273, 13.149999618530273, 8.5, 1.850000023841858, 3.299999952316284, 9.0"
KAJARIACER,4,3,1,4719,4.72,"579.2999877929688, 439.6499938964844, 549.1500244140625, 392.3999938964844","584.3499755859375, 493.1000061035156, 558.2999877929688, 405.3999938964844"
KALAMANDIR,0,0,0,0,0.0,,
KALYANKJIL,0,0,0,0,0.0,,
KANSAINER,5,2,3,1035,1.04,"27.626665115356445, 23.958332061767578, 297.6000061035156, 336.8666687011719, 293.8999938964844","29.841665267944336, 23.333332061767578, 289.0333251953125, 326.4333190917969, 300.29998779296875"
KARURVYSYA,6,5,1,18080,18.08,"22.89509391784668, 63.57308578491211, 77.4000015258789, 63.150001525878906, 33.75, 37.5","30.40814781188965, 65.95305633544922, 78.0999984741211, 60.25, 34.54999923706055, 45.75"
KAYNES,0,0,0,0,0.0,,
KCP,5,2,3,30400,30.4,"21.524999618530273, 18.155000686645508, 99.0999984741211, 64.1500015258789, 105.80000305175781","27.875, 30.9950008392334, 90.1500015258789, 60.45000076293945, 102.4000015258789"
KDDL,3,1,2,-6599,-6.6,"477.8548278808594, 368.7492370605469, 161.53741455078125","490.9751281738281, 361.30126953125, 121.3380355834961"
KEC,7,5,2,41201,41.2,"32.95000076293945, 41.2599983215332, 101.3499984741211, 53.45000076293945, 36.29999923706055, 125.5, 270.6499938964844","32.13999938964844, 83.01000213623047, 91.05000305175781, 62.0, 44.70000076293945, 138.5500030517578, 274.95001220703125"
KEI,4,3,1,21414,21.41,"60.22999954223633, 13.850000381469727, 25.299999237060547, 348.79998779296875","63.84000015258789, 22.549999237060547, 23.5, 348.1499938964844"
KESORAMIND,11,6,5,4,0.0,"253.3616180419922, 84.86155700683594, 75.89244842529297, 66.17069244384766, 47.236507415771484, 76.8486328125, 68.15553283691406, 57.79525375366211, 29.128854751586914, 60.5, 51.25","284.43988037109375, 96.62174987792969, 73.1640853881836, 57.31892013549805, 48.18917465209961, 72.5616226196289, 68.79064178466797, 52.714351654052734, 30.069875717163086, 52.95000076293945, 56.650001525878906"
KFINTECH,0,0,0,0,0.0,,
KICL,6,4,2,18990,18.99,"60.5, 1700.0, 2396.89990234375, 1784.699951171875, 1281.3499755859375, 1727.0","103.6500015258789, 1626.0999755859375, 2087.949951171875, 1869.0999755859375, 1267.25, 1619.0999755859375"
KIMS,0,0,0,0,0.0,,
KINGFA,4,1,3,-4907,-4.91,"770.5499877929688, 669.0999755859375, 647.8499755859375, 2113.35009765625","735.6500244140625, 676.25, 570.5, 1958.449951171875"
KIOCL,0,0,0,0,0.0,,
KIRLOSBROS,7,4,3,-1424,-1.42,"188.3000030517578, 133.25, 165.0, 128.25, 159.10000610351562, 115.6500015258789, 324.5","147.5500030517578, 139.64999389648438, 186.25, 123.0, 163.64999389648438, 131.0500030517578, 265.0"
KIRLOSENG,5,2,3,-11876,-11.88,"207.60000610351562, 55.0, 236.8000030517578, 297.95001220703125, 162.4499969482422","226.4499969482422, 52.349998474121094, 244.89999389648438, 201.35000610351562, 153.75"
KIRLOSIND,4,1,3,-4856,-4.86,"103.80000305175781, 56.849998474121094, 644.3499755859375, 666.6500244140625","113.2249984741211, 52.349998474121094, 594.0, 616.7999877929688"
KIRLPNU,1,1,0,3675,3.67,602.4000244140625,675.8499755859375
KKCL,4,2,2,-1157,-1.16,"50.9900016784668, 41.810001373291016, 260.07000732421875, 200.0399932861328","46.2400016784668, 45.47999954223633, 265.54998779296875, 187.17999267578125"
KNRCON,7,2,5,-13400,-13.4,"7.230000019073486, 4.045000076293945, 12.53499984741211, 8.5, 120.5, 106.57499694824219, 261.75","5.385000228881836, 3.009999990463257, 12.984999656677246, 10.899999618530273, 89.125, 102.875, 254.85000610351562"
KOLTEPATIL,2,2,0,36022,36.02,"26.5, 124.0999984741211","54.900001525878906, 128.10000610351562"
KOTAKBANK,6,5,1,26931,26.93,"151.3249969482422, 96.3125, 339.04998779296875, 390.5249938964844, 1360.449951171875, 1938.050048828125","138.53750610351562, 169.6374969482422, 376.2250061035156, 401.29998779296875, 1365.75, 2014.3499755859375"
KPIGREEN,0,0,0,0,0.0,,
KPIL,0,0,0,0,0.0,,
KPITTECH,1,1,0,666,0.67,63.0,64.30000305175781
KPRMILL,5,4,1,26376,26.38,"3.1549999713897705, 13.574999809265137, 115.20999908447266, 96.80000305175781, 575.5499877929688","5.445000171661377, 15.564998626708984, 119.94999694824219, 83.86000061035156, 578.0999755859375"
KRBL,10,7,3,7031,7.03,"12.234999656677246, 6.300000190734863, 20.399999618530273, 24.5, 208.5500030517578, 536.9000244140625, 384.20001220703125, 333.79998779296875, 246.10000610351562, 210.10000610351562","12.704999923706055, 8.505000114440918, 17.5, 24.350000381469727, 233.64999389648438, 337.25, 327.1499938964844, 352.0, 270.54998779296875, 235.5"
KRSNAA,1,0,1,-4165,-4.17,608.4500122070312,520.25
KSB,6,1,5,-6387,-6.39,"153.5, 285.25, 206.14999389648438, 607.2000122070312, 631.1500244140625, 693.4500122070312","146.52499389648438, 269.95001220703125, 204.5, 572.0, 612.75, 696.2000122070312"
KSCL,7,3,4,-3740,-3.74,"29.809999465942383, 505.3500061035156, 377.6000061035156, 431.95001220703125, 534.7000122070312, 574.6500244140625, 571.0","29.809999465942383, 423.70001220703125, 395.45001220703125, 415.29998779296875, 535.9500122070312, 600.7000122070312, 551.9500122070312"
KSL,6,3,3,3720,3.72,"61.0, 52.29999923706055, 141.25, 292.8500061035156, 214.6999969482422, 196.89999389648438","34.54999923706055, 58.599998474121094, 136.3000030517578, 230.8000030517578, 197.1999969482422, 215.3000030517578"
KTKBANK,6,4,2,31472,31.47,"56.26078796386719, 96.82949829101562, 64.13334655761719, 61.8005485534668, 95.31133270263672, 76.01949310302734","94.15559387207031, 85.72095489501953, 75.01972198486328, 75.01972198486328, 93.94127655029297, 82.83273315429688"
L&TFH,7,3,4,6584,6.58,"45.622093200683594, 59.387779235839844, 90.73262023925781, 161.0957489013672, 134.1224365234375, 111.93922424316406, 61.248008728027344","45.34305953979492, 66.64266967773438, 108.31177520751953, 157.9798583984375, 141.93539428710938, 110.2650146484375, 55.80684280395508"
LALPATHLAB,4,3,1,9334,9.33,"889.7999877929688, 2303.60009765625, 2032.949951171875, 2372.449951171875","881.2999877929688, 2566.300048828125, 2259.39990234375, 2647.85009765625"
LANDMARK,0,0,0,0,0.0,,
LAOPALA,4,3,1,9569,9.57,"2.7249999046325684, 243.02499389648438, 182.35000610351562, 290.75","2.25, 269.07501220703125, 216.85000610351562, 355.29998779296875"
LATENTVIEW,0,0,0,0,0.0,,
LAURUSLABS,1,1,0,3002,3.0,330.70001220703125,366.6499938964844
LAXMIMACH,5,2,3,14446,14.45,"583.0, 1735.5999755859375, 3540.25, 6079.0498046875, 2851.85009765625","914.6500244140625, 1583.5, 3432.199951171875, 5773.0498046875, 2992.64990234375"
LEMONTREE,1,0,1,-526,-0.53,22.799999237060547,23.600000381469727
LGBBROSLTD,5,3,2,6612,6.61,"78.55000305175781, 42.525001525878906, 310.5, 220.0, 742.2999877929688","72.4749984741211, 53.25, 247.64999389648438, 245.89999389648438, 869.75"
LICHSGFIN,6,4,2,6178,6.18,"32.849998474121094, 187.9499969482422, 466.3500061035156, 464.1000061035156, 427.04998779296875, 372.0","33.77000045776367, 224.5500030517578, 488.70001220703125, 434.1499938964844, 406.8500061035156, 392.20001220703125"
LICI,2,2,0,4209,4.21,"636.2999877929688, 595.1500244140625","684.5999755859375, 632.25"
LINDEINDIA,4,3,1,5722,5.72,"144.0, 285.6000061035156, 273.8500061035156, 613.0999755859375","142.25, 308.75, 285.6499938964844, 632.7999877929688"
LLOYDSENGG,0,0,0,0,0.0,,
LLOYDSME,0,0,0,0,0.0,,
LODHA,1,1,0,2379,2.38,534.5,572.25
LT,10,5,5,15209,15.21,"267.0833435058594, 390.8222351074219, 621.2444458007812, 811.1333618164062, 964.1666870117188, 1432.5, 1385.300048828125, 1474.25, 1369.300048828125, 943.6500244140625","282.76666259765625, 623.2000122070312, 608.6221923828125, 836.4000244140625, 979.4666748046875, 1437.550048828125, 1348.550048828125, 1473.050048828125, 1187.550048828125, 913.4500122070312"
LTFOODS,0,0,0,0,0.0,,
LTIM,3,1,2,1063,1.06,"680.0499877929688, 1798.8499755859375, 4730.75","668.75, 1957.9000244140625, 4641.7001953125"
LTTS,2,1,1,4396,4.4,"1283.050048828125, 3714.0","1511.3499755859375, 3591.60009765625"
LUMAXIND,4,2,2,10829,10.83,"164.0500030517578, 88.0, 354.8500061035156, 1084.550048828125","117.1500015258789, 127.5, 344.70001220703125, 1240.8499755859375"
LUMAXTECH,4,1,3,10772,10.77,"4.079999923706055, 20.81999969482422, 57.790000915527344, 69.83000183105469","6.269999980926514, 19.959999084472656, 51.45000076293945, 64.5"
LUPIN,3,2,1,397,0.4,"1739.8499755859375, 644.0999755859375, 709.5","1482.199951171875, 669.0999755859375, 804.5"
LUXIND,4,1,3,526,0.53,"1373.25, 1203.199951171875, 1152.0999755859375, 1362.0999755859375","1322.3499755859375, 1217.1500244140625, 1122.0999755859375, 1481.9000244140625"
LXCHEM,0,0,0,0,0.0,,
M&M,10,7,3,10899,10.9,"188.0, 144.66250610351562, 95.9124984741211, 354.92498779296875, 355.0249938964844, 620.0499877929688, 567.1500244140625, 436.3500061035156, 922.0999755859375, 1319.0","188.6125030517578, 127.375, 121.98750305175781, 350.1000061035156, 326.29998779296875, 656.0750122070312, 457.04998779296875, 510.70001220703125, 1034.3499755859375, 1453.5999755859375"
M&MFIN,7,5,2,-3446,-3.45,"27.314441680908203, 31.679874420166016, 30.91165542602539, 86.53434753417969, 148.79664611816406, 273.9065246582031, 130.25","28.65577507019043, 22.503929138183594, 23.851360321044922, 89.93645477294922, 182.90921020507812, 288.78314208984375, 134.6999969482422"
MAHABANK,6,3,3,27062,27.06,"26.350000381469727, 23.100000381469727, 39.599998474121094, 43.849998474121094, 27.799999237060547, 11.0","31.200000762939453, 38.25, 38.25, 42.79999923706055, 26.899999618530273, 12.149999618530273"
MAHLIFE,7,5,2,26499,26.5,"52.221107482910156, 119.42228698730469, 89.5860824584961, 122.8613510131836, 129.1666717529297, 70.66666412353516, 90.38333129882812","88.09891510009766, 116.1071548461914, 100.69332885742188, 133.47286987304688, 147.3333282470703, 70.19999694824219, 78.25"
MAHLOG,2,1,1,1442,1.44,"274.70001220703125, 382.79998779296875","297.79998779296875, 358.29998779296875"
MAHSCOOTER,6,4,2,10218,10.22,"79.30000305175781, 400.6499938964844, 404.20001220703125, 2778.5, 2504.550048828125, 3879.699951171875","82.0999984741211, 411.8999938964844, 396.29998779296875, 3175.550048828125, 3004.300048828125, 3830.35009765625"
MAHSEAMLES,6,2,4,-14279,-14.28,"167.3000030517578, 316.1000061035156, 71.2750015258789, 179.8249969482422, 87.5999984741211, 193.625","177.72500610351562, 191.0500030517578, 80.4749984741211, 179.0, 73.69999694824219, 160.14999389648438"
MAITHANALL,3,0,3,-8080,-8.08,"34.0, 483.0, 471.04998779296875","30.774999618530273, 448.54998779296875, 426.5"
MANAPPURAM,7,5,2,4030,4.03,"31.399999618530273, 18.600000381469727, 16.350000381469727, 26.649999618530273, 86.30000305175781, 151.35000610351562, 98.3499984741211","33.54999923706055, 14.5, 15.649999618530273, 29.450000762939453, 93.0, 158.5, 105.80000305175781"
MANGLMCEM,5,4,1,8360,8.36,"269.1000061035156, 219.60000610351562, 168.14999389648438, 342.8500061035156, 290.0","222.4499969482422, 267.29998779296875, 187.0, 376.3500061035156, 308.29998779296875"
MANINDS,5,3,2,18782,18.78,"159.14999389648438, 32.04999923706055, 83.0, 69.05000305175781, 65.9000015258789","121.25, 49.54999923706055, 124.0999984741211, 57.5, 67.5"
MANINFRA,6,2,4,18,0.02,"44.6533317565918, 18.373332977294922, 14.75333309173584, 21.899999618530273, 17.799999237060547, 91.25","48.82666778564453, 17.31999969482422, 18.00666618347168, 20.200000762939453, 15.133333206176758, 89.1500015258789"
MANKIND,0,0,0,0,0.0,,
MANORAMA,1,0,1,-738,-0.74,634.9000244140625,608.2999877929688
MANYAVAR,1,1,0,342,0.34,1272.1500244140625,1287.5
MAPMYINDIA,1,0,1,-559,-0.56,2009.9000244140625,1917.699951171875
MARATHON,2,1,1,2380,2.38,"108.05000305175781, 52.20000076293945","131.25, 48.25"
MARICO,1,1,0,648,0.65,27.519453048706055,28.832263946533203
MARKSANS,6,2,4,-17132,-17.13,"22.454999923706055, 5.454999923706055, 6.150000095367432, 37.79999923706055, 53.79999923706055, 48.75","22.864999771118164, 4.880000114440918, 5.300000190734863, 29.399999618530273, 46.79999923706055, 52.25"
MARUTI,6,4,2,2169,2.17,"1423.75, 1440.9000244140625, 1186.699951171875, 3794.64990234375, 7661.60009765625, 5610.7998046875","1198.5999755859375, 1551.5999755859375, 1254.800048828125, 4161.60009765625, 7465.5, 5838.2998046875"
MASFIN,3,2,1,4378,4.38,"177.36666870117188, 220.68333435058594, 259.1499938964844","199.8000030517578, 214.0500030517578, 262.54998779296875"
MASTEK,6,4,2,36141,36.14,"331.1000061035156, 140.0, 201.5, 143.25, 386.70001220703125, 265.3999938964844","321.1000061035156, 250.0, 187.39999389648438, 145.25, 418.29998779296875, 399.0"
MAXESTATES,1,1,0,6543,6.54,294.1000061035156,348.8999938964844
MAXHEALTH,0,0,0,0,0.0,,
MAYURUNIQ,3,2,1,340,0.34,"230.39999389648438, 205.85000610351562, 487.25","254.25, 218.5, 420.04998779296875"
MAZDOCK,0,0,0,0,0.0,,
MBAPL,2,1,1,1326,1.33,"16.625, 13.5","16.987499237060547, 15.0"
MCDOWELL-N,9,5,4,-2917,-2.92,"271.7699890136719, 156.2899932861328, 552.77001953125, 435.70001220703125, 453.07000732421875, 672.4000244140625, 584.9500122070312, 619.0, 883.5","253.1300048828125, 112.73999786376953, 547.1099853515625, 469.0199890136719, 479.6700134277344, 635.7999877929688, 594.0499877929688, 686.3499755859375, 912.2000122070312"
MCX,3,1,2,-3845,-3.84,"499.75, 925.7999877929688, 1396.9000244140625","525.9500122070312, 854.5999755859375, 1289.25"
MEDANTA,0,0,0,0,0.0,,
MEDPLUS,2,0,2,-3472,-3.47,"685.25, 665.5999755859375","613.5999755859375, 649.7000122070312"
METROBRAND,0,0,0,0,0.0,,
METROPOLIS,3,0,3,-13213,-13.21,"1384.949951171875, 2397.800048828125, 1691.800048828125","1359.300048828125, 1616.300048828125, 1468.199951171875"
MFSL,5,3,2,14670,14.67,"139.5500030517578, 365.20001220703125, 515.7000122070312, 447.29998779296875, 706.5499877929688","191.14999389648438, 356.04998779296875, 490.1000061035156, 446.0, 810.8499755859375"
MGL,2,0,2,-1824,-1.82,"911.7999877929688, 1063.9000244140625","865.75, 1061.199951171875"
MHRIL,5,3,2,3887,3.89,"111.26667022705078, 186.08888244628906, 218.46665954589844, 159.63333129882812, 111.80000305175781","115.35555267333984, 192.977783203125, 232.23333740234375, 157.03334045410156, 111.9000015258789"
MIDHANI,1,1,0,4484,4.48,126.6500015258789,145.6999969482422
MINDACORP,3,0,3,-6521,-6.52,"20.160001754760742, 21.899999618530273, 73.30000305175781","20.0, 20.0, 66.80000305175781"
MMFL,3,0,3,-7570,-7.57,"233.47500610351562, 425.1000061035156, 467.79998779296875","224.4250030517578, 402.79998779296875, 383.20001220703125"
MMTC,3,1,2,-3033,-3.03,"594.8333129882812, 35.43333435058594, 41.900001525878906","566.0999755859375, 36.86666488647461, 37.79999923706055"
MOIL,3,1,2,-3761,-3.76,"131.3000030517578, 136.6999969482422, 143.0500030517578","123.57499694824219, 139.0500030517578, 135.14999389648438"
MOL,1,0,1,-2630,-2.63,89.4000015258789,81.6500015258789
MOLDTKPAC,2,1,1,1683,1.68,"256.37969970703125, 199.4119415283203","245.00601196289062, 228.21865844726562"
MOREPENLAB,6,2,4,15039,15.04,"5.800000190734863, 3.5999999046325684, 20.200000762939453, 18.299999237060547, 48.599998474121094, 30.700000762939453","9.350000381469727, 3.5999999046325684, 18.200000762939453, 16.0, 40.25, 37.849998474121094"
MOTHERSON,5,2,3,392,0.39,"4.441627025604248, 8.815793991088867, 52.69440841674805, 96.36355590820312, 39.05633544921875","4.533373832702637, 10.302633285522461, 53.39566421508789, 84.7381820678711, 38.78995132446289"
MOTILALOFS,2,2,0,4931,4.93,"647.6500244140625, 591.7999877929688","620.9500122070312, 681.5"
MPHASIS,4,0,4,-7854,-7.85,"242.8000030517578, 1041.199951171875, 860.9500122070312, 1946.8499755859375","187.89999389648438, 991.0999755859375, 878.75, 1895.050048828125"
MPSLTD,4,2,2,8231,8.23,"55.5, 66.3499984741211, 38.45000076293945, 476.79998779296875","79.1500015258789, 61.5, 33.0, 485.20001220703125"
MRF,1,1,0,13390,13.39,2210.0,3161.89990234375
MRPL,12,7,5,-6063,-6.06,"41.599998474121094, 40.5, 101.69999694824219, 73.6500015258789, 58.45000076293945, 40.25, 66.94999694824219, 81.69999694824219, 74.30000305175781, 54.650001525878906, 36.650001525878906, 35.45000076293945","42.599998474121094, 41.20000076293945, 83.0999984741211, 73.94999694824219, 61.849998474121094, 41.95000076293945, 67.8499984741211, 73.9000015258789, 71.8499984741211, 47.650001525878906, 36.400001525878906, 35.900001525878906"
MSTCLTD,2,1,1,828,0.83,"112.44999694824219, 274.8999938964844","122.19999694824219, 253.89999389648438"
MSUMI,1,1,0,2372,2.37,53.75,57.849998474121094
MTARTECH,1,0,1,-937,-0.94,1645.449951171875,1583.699951171875
MTNL,10,4,6,-4509,-4.51,"103.6500015258789, 79.1500015258789, 67.4000015258789, 48.349998474121094, 30.799999237060547, 14.850000381469727, 19.0, 18.649999618530273, 7.699999809265137, 9.100000381469727","99.0, 72.30000305175781, 61.20000076293945, 45.400001525878906, 32.150001525878906, 14.5, 15.699999809265137, 20.950000762939453, 9.0, 9.25"
MUFIN,0,0,0,0,0.0,,
MUKANDLTD,5,3,2,12909,12.91,"23.0, 47.54999923706055, 31.899999618530273, 35.04999923706055, 22.5","31.850000381469727, 44.5, 34.900001525878906, 36.70000076293945, 19.75"
MUTHOOTFIN,7,3,4,-1991,-1.99,"113.5999984741211, 108.69999694824219, 180.35000610351562, 203.10000610351562, 450.8500061035156, 404.54998779296875, 1020.7000122070312","90.55000305175781, 107.94999694824219, 180.89999389648438, 232.39999389648438, 389.6499938964844, 409.3999938964844, 1115.5"
MUTHOOTMF,0,0,0,0,0.0,,
NAM-INDIA,4,2,2,-556,-0.56,"252.85000610351562, 182.1999969482422, 314.3500061035156, 238.1999969482422","235.75, 209.6999969482422, 265.8500061035156, 249.75"
NATCOPHARM,6,3,3,-2776,-2.78,"10.979999542236328, 968.1500244140625, 807.8499755859375, 542.0499877929688, 904.6500244140625, 563.3499755859375","9.550000190734863, 940.5999755859375, 807.7999877929688, 581.9500122070312, 910.3499755859375, 574.9500122070312"
NATIONALUM,13,6,7,-5476,-5.48,"39.1875, 53.662498474121094, 57.20000076293945, 49.0, 33.75, 39.75, 39.5, 80.55000305175781, 74.8499984741211, 46.45000076293945, 31.850000381469727, 80.5, 77.0","42.3125, 52.70000076293945, 60.75, 49.25, 32.54999923706055, 38.20000076293945, 46.150001525878906, 70.44999694824219, 60.599998474121094, 45.400001525878906, 32.75, 71.30000305175781, 80.4000015258789"
NAUKRI,2,1,1,3015,3.01,"325.04998779296875, 4336.39990234375","364.5, 4344.2998046875"
NAVA,5,2,3,9534,9.53,"55.70000076293945, 69.0, 97.57499694824219, 84.44999694824219, 51.099998474121094","77.375, 95.25, 77.1500015258789, 75.25, 46.20000076293945"
NAVINFLUOR,6,2,4,16888,16.89,"56.150001525878906, 25.200000762939453, 36.2400016784668, 707.5999755859375, 3853.199951171875, 3419.25","49.18000030517578, 37.95000076293945, 49.02000045776367, 670.5999755859375, 3417.5, 3187.39990234375"
NAVNETEDUL,4,1,3,285,0.29,"56.75, 96.4000015258789, 76.55000305175781, 115.05000305175781","56.29999923706055, 91.0999984741211, 73.6500015258789, 123.5999984741211"
NAZARA,1,1,0,4825,4.82,551.7000122070312,641.0499877929688
NBCC,2,0,2,-3964,-3.96,"104.9000015258789, 23.25","92.0999984741211, 23.100000381469727"
NCC,11,6,5,3899,3.9,"89.22489166259766, 109.86327362060547, 37.824790954589844, 34.825740814208984, 15.821535110473633, 80.3499984741211, 75.80000305175781, 87.0, 29.149999618530273, 68.55000305175781, 70.05000305175781","97.31621551513672, 98.69332885742188, 42.56819152832031, 36.508880615234375, 15.454303741455078, 77.55000305175781, 78.0999984741211, 88.1500015258789, 29.0, 64.55000305175781, 71.75"
NEOGEN,2,1,1,735,0.74,"1266.300048828125, 1542.5","1286.199951171875, 1481.949951171875"
NESCO,5,4,1,20134,20.13,"61.05500030517578, 140.83999633789062, 292.4599914550781, 554.0499877929688, 553.9500122070312","82.9800033569336, 150.25999450683594, 333.6000061035156, 538.6500244140625, 605.3499755859375"
NESTLEIND,1,1,0,1771,1.77,625.4249877929688,668.0650024414062
NETWEB,0,0,0,0,0.0,,
NETWORK18,5,2,3,13967,13.97,"387.48382568359375, 196.20631408691406, 83.64034271240234, 38.0, 47.54999923706055","494.8720397949219, 142.83580017089844, 126.50602722167969, 35.5, 43.349998474121094"
NEULANDLAB,4,1,3,2257,2.26,"107.03384399414062, 224.7710723876953, 532.5, 1325.5","94.61027526855469, 206.99581909179688, 762.75, 1073.9000244140625"
NEWGEN,1,0,1,-3325,-3.33,112.4749984741211,98.3499984741211
NFL,6,2,4,-4565,-4.57,"83.19999694824219, 24.5, 28.649999618530273, 28.549999237060547, 25.299999237060547, 50.349998474121094","90.3499984741211, 24.100000381469727, 26.450000762939453, 22.600000381469727, 25.350000381469727, 47.75"
NH,2,0,2,-2181,-2.18,"307.0, 259.79998779296875","298.95001220703125, 252.3000030517578"
NHPC,5,2,3,-2642,-2.64,"25.299999237060547, 21.200000762939453, 19.549999237060547, 18.149999618530273, 28.450000762939453","25.899999618530273, 19.700000762939453, 18.100000381469727, 19.299999237060547, 26.5"
NIACL,5,2,3,-1021,-1.02,"189.75, 167.8000030517578, 117.55000305175781, 97.19999694824219, 109.25","180.14999389648438, 148.35000610351562, 128.85000610351562, 85.8499984741211, 125.75"
NIITMTS,0,0,0,0,0.0,,
NILKAMAL,4,3,1,8507,8.51,"120.8499984741211, 1429.6500244140625, 1208.9000244140625, 1142.5999755859375","155.6999969482422, 1326.949951171875, 1261.75, 1229.5999755859375"
NLCINDIA,5,4,1,5342,5.34,"112.44999694824219, 89.8499984741211, 61.150001525878906, 58.70000076293945, 46.150001525878906","104.9000015258789, 90.5999984741211, 69.5999984741211, 59.95000076293945, 47.70000076293945"
NMDC,5,4,1,3154,3.15,"91.46845245361328, 97.42543029785156, 85.7036361694336, 77.40229797363281, 93.96653747558594","92.31395721435547, 97.34856414794922, 87.01032257080078, 80.28470611572266, 98.19407653808594"
NOCIL,5,3,2,19964,19.96,"28.950000762939453, 23.799999237060547, 16.0, 169.8000030517578, 112.19999694824219","24.75, 25.0, 27.450000762939453, 165.14999389648438, 121.44999694824219"
NRBBEARING,5,3,2,-2643,-2.64,"41.20000076293945, 124.44999694824219, 109.05000305175781, 77.55000305175781, 134.9499969482422","41.45000076293945, 125.0, 95.6500015258789, 77.75, 136.64999389648438"
NSLNISP,1,1,0,10786,10.79,51.400001525878906,69.6500015258789
NTPC,5,1,4,-985,-0.99,"103.54166412353516, 131.125, 110.66666412353516, 142.9166717529297, 134.6999969482422","108.41666412353516, 128.5, 109.08333587646484, 139.0416717529297, 134.0500030517578"
NUCLEUS,4,2,2,3489,3.49,"189.02999877929688, 365.8500061035156, 61.0, 93.6500015258789","190.9499969482422, 275.3999938964844, 84.69999694824219, 84.5999984741211"
NUVAMA,0,0,0,0,0.0,,
NUVOCO,1,1,0,2583,2.58,331.1000061035156,359.8500061035156
NYKAA,1,0,1,-975,-0.97,148.60000610351562,143.89999389648438
OBEROIRLTY,5,3,2,1818,1.82,"264.8999938964844, 188.10000610351562, 446.29998779296875, 365.79998779296875, 910.1500244140625","273.04998779296875, 192.9499969482422, 440.8500061035156, 349.8999938964844, 1006.8499755859375"
OFSS,7,3,4,6029,6.03,"1397.0, 608.3499755859375, 2113.699951171875, 3685.949951171875, 3707.75, 2491.800048828125, 3107.85009765625","1375.8499755859375, 718.5499877929688, 2031.75, 3456.60009765625, 3801.050048828125, 2863.75, 3023.35009765625"
OIL,7,4,3,-155,-0.16,"242.29005432128906, 270.00006103515625, 242.02505493164062, 166.02503967285156, 185.4499969482422, 171.64999389648438, 204.64999389648438","256.5900573730469, 264.00006103515625, 238.62506103515625, 175.0000457763672, 180.85000610351562, 154.0500030517578, 208.1999969482422"
OLECTRA,5,2,3,21453,21.45,"19.899999618530273, 14.350000381469727, 10.050000190734863, 72.5999984741211, 67.94999694824219","18.100000381469727, 13.050000190734863, 10.75, 58.70000076293945, 135.75"
ONGC,7,3,4,1405,1.41,"130.35000610351562, 205.1999969482422, 164.63333129882812, 180.0500030517578, 83.19999694824219, 78.5, 141.10000610351562","135.2888946533203, 187.36666870117188, 156.10000610351562, 177.1999969482422, 81.3499984741211, 93.05000305175781, 146.75"
OPTIEMUS,3,0,3,-11738,-11.74,"117.30000305175781, 25.549999237060547, 232.4499969482422","97.1500015258789, 21.350000381469727, 210.5"
ORCHPHARMA,6,4,2,18656,18.66,"77.19999694824219, 119.69999694824219, 51.54999923706055, 59.70000076293945, 5.5, 359.70001220703125","96.25, 181.5500030517578, 53.75, 66.5, 5.0, 309.45001220703125"
ORIENTCEM,5,2,3,3162,3.16,"152.39999389648438, 154.3000030517578, 79.0, 77.25, 71.4000015258789","147.64999389648438, 131.39999389648438, 106.6500015258789, 79.6500015258789, 64.3499984741211"
ORIENTELEC,1,0,1,-3822,-3.82,203.64999389648438,179.5500030517578
ORIENTHOT,3,1,2,-925,-0.92,"34.119998931884766, 22.649999618530273, 19.25","36.11000061035156, 21.200000762939453, 19.149999618530273"
ORISSAMINE,4,3,1,15252,15.25,"1830.1500244140625, 789.8499755859375, 820.1500244140625, 2918.449951171875","2004.5999755859375, 976.9000244140625, 982.0, 2864.39990234375"
PAGEIND,3,1,2,949,0.95,"24972.25, 22517.849609375, 19914.599609375","23091.849609375, 25750.900390625, 19818.25"
PAISALO,6,2,4,4953,4.95,"10.175000190734863, 18.657499313354492, 13.770000457763672, 9.34749984741211, 10.15999984741211, 10.725000381469727","8.774999618530273, 16.375, 13.949999809265137, 8.75, 8.920000076293945, 16.657499313354492"
PANAMAPET,4,0,4,-2208,-2.21,"12.399999618530273, 129.3000030517578, 129.3000030517578, 42.150001525878906","11.915555000305176, 128.14999389648438, 122.8499984741211, 41.04999923706055"
PARACABLES,4,1,3,-576,-0.58,"32.599998474121094, 9.399999618530273, 4.150000095367432, 14.050000190734863","27.75, 13.149999618530273, 3.5, 12.75"
PARADEEP,0,0,0,0,0.0,,
PARAGMILK,5,1,4,-2466,-2.47,"243.4499969482422, 260.75, 90.94999694824219, 95.8499984741211, 87.5","237.39999389648438, 241.5, 87.55000305175781, 84.69999694824219, 98.9000015258789"
PARAS,1,0,1,-1066,-1.07,715.6500244140625,697.7999877929688
PATANJALI,5,3,2,54044,54.04,"2745.0, 3285.0, 895.0, 172.0500030517578, 1047.5","4660.0, 2855.0, 690.0, 413.54998779296875, 1188.699951171875"
PATELENG,9,5,4,25176,25.18,"228.5714111328125, 277.9200744628906, 116.17572784423828, 111.91017150878906, 70.57241821289062, 51.70686721801758, 63.879310607910156, 33.1881103515625, 12.696520805358887","226.1091766357422, 282.7751770019531, 263.1813659667969, 101.99188232421875, 75.73963928222656, 53.128719329833984, 58.81612777709961, 23.09642791748047, 12.65101432800293"
PAYTM,1,1,0,1544,1.54,675.7000122070312,706.7999877929688
PCBL,9,6,3,33060,33.06,"6.09499979019165, 20.21500015258789, 4.570000171661377, 10.760000228881836, 4.349999904632568, 13.295000076293945, 11.960000038146973, 44.224998474121094, 128.3000030517578","7.485000133514404, 17.364999771118164, 7.684999942779541, 11.194999694824219, 5.434999942779541, 11.40999984741211, 11.824999809265137, 48.099998474121094, 136.5"
PCJEWELLER,4,1,3,-907,-0.91,"68.8499984741211, 16.700000762939453, 22.049999237060547, 29.299999237060547","86.19999694824219, 14.850000381469727, 20.200000762939453, 26.600000381469727"
PDSL,1,1,0,5845,5.85,33.79999923706055,40.38999938964844
PEL,6,4,2,10596,10.6,"112.37118530273438, 131.06373596191406, 1474.3394775390625, 1026.7802734375, 792.3703002929688, 771.25","124.60435485839844, 146.56922912597656, 1344.9462890625, 885.185302734375, 856.048095703125, 942.2999877929688"
PENIND,1,0,1,-6189,-6.19,18.899999618530273,15.75
PENINLAND,7,5,2,26596,26.6,"104.0999984741211, 34.5, 37.20000076293945, 36.0, 24.200000762939453, 16.950000762939453, 5.5","80.8499984741211, 67.0, 40.599998474121094, 36.75, 25.350000381469727, 18.700000762939453, 4.099999904632568"
PERSISTENT,5,3,2,17812,17.81,"350.5, 303.2250061035156, 311.32501220703125, 317.54998779296875, 1846.5250244140625","332.82501220703125, 341.07501220703125, 301.04998779296875, 459.04998779296875, 2077.35009765625"
PETRONET,4,2,2,2788,2.79,"24.600000381469727, 40.025001525878906, 227.60000610351562, 222.64999389648438","24.049999237060547, 34.92499923706055, 238.5500030517578, 269.1000061035156"
PFC,6,3,3,-1766,-1.77,"53.2400016784668, 64.73999786376953, 52.36000061035156, 71.73999786376953, 87.22000122070312, 69.83999633789062","55.540000915527344, 55.2599983215332, 53.7599983215332, 65.4800033569336, 98.95999908447266, 67.5199966430664"
PFIZER,5,2,3,-34,-0.03,"819.8499755859375, 1196.25, 1892.800048828125, 1999.0, 1915.25","921.0499877929688, 1152.449951171875, 1895.3499755859375, 1992.1500244140625, 1737.5999755859375"
PFOCUS,4,2,2,9276,9.28,"11.25, 32.25, 47.400001525878906, 37.25","19.040000915527344, 27.399999618530273, 25.600000381469727, 42.04999923706055"
PFS,6,4,2,7906,7.91,"14.949999809265137, 11.25, 19.5, 15.899999618530273, 14.5, 12.550000190734863","16.600000381469727, 11.5, 14.600000381469727, 16.200000762939453, 12.75, 17.649999618530273"
PGEL,8,5,3,12409,12.41,"207.0, 223.1999969482422, 84.5999984741211, 107.5, 104.94999694824219, 56.849998474121094, 44.599998474121094, 2108.75","201.9499969482422, 253.75, 107.69999694824219, 74.8499984741211, 94.69999694824219, 70.69999694824219, 41.70000076293945, 2590.14990234375"
PGHH,3,2,1,3343,3.34,"1805.0999755859375, 5771.39990234375, 10351.849609375","2000.550048828125, 6284.25, 9986.849609375"
PGHL,2,0,2,-2580,-2.58,"424.75, 634.2999877929688","416.45001220703125, 590.7000122070312"
PGIL,4,1,3,13455,13.45,"29.075000762939453, 110.2750015258789, 75.19999694824219, 62.67499923706055","49.04999923706055, 100.0, 59.150001525878906, 61.29999923706055"
PHOENIXLTD,4,2,2,13904,13.9,"75.94999694824219, 67.8499984741211, 614.5499877929688, 584.9500122070312","67.75, 111.0, 563.5999755859375, 617.0"
PIDILITIND,3,3,0,4292,4.29,"48.92499923706055, 673.5, 2419.25","50.849998474121094, 682.1500244140625, 2607.85009765625"
PIIND,1,1,0,0,0.0,2819.64990234375,2847.949951171875
PILANIINVS,5,3,2,4939,4.94,"1071.5, 814.2857055664062, 1071.4642333984375, 1802.0714111328125, 1785.5999755859375","1096.7857666015625, 1000.0, 1014.3571166992188, 1642.9285888671875, 1700.699951171875"
PITTIENG,5,2,3,12066,12.07,"13.175000190734863, 18.75, 34.75, 42.75, 31.350000381469727","20.549999237060547, 14.5, 35.650001525878906, 42.20000076293945, 28.149999618530273"
PNB,7,2,5,-13043,-13.04,"94.29000091552734, 224.77999877929688, 168.05999755859375, 105.9000015258789, 88.1500015258789, 34.75, 33.45000076293945","105.26000213623047, 185.91000366210938, 147.67999267578125, 123.3499984741211, 59.70000076293945, 31.950000762939453, 33.04999923706055"
PNBHOUSING,2,2,0,6647,6.65,"171.90127563476562, 236.33836364746094","173.2678680419922, 280.0694580078125"
PNCINFRA,3,1,2,-7456,-7.46,"166.6999969482422, 145.0, 143.14999389648438","137.0500030517578, 147.39999389648438, 133.39999389648438"
POKARNA,4,3,1,7661,7.66,"227.1999969482422, 84.8499984741211, 539.25, 350.45001220703125","213.5, 103.5999984741211, 552.6500244140625, 368.20001220703125"
POLICYBZR,0,0,0,0,0.0,,
POLYCAB,1,1,0,1106,1.11,789.2999877929688,820.2999877929688
POLYMED,2,0,2,-8638,-8.64,"199.39999389648438, 242.25","164.1750030517578, 213.8000030517578"
POLYPLEX,6,3,3,4122,4.12,"54.07500076293945, 132.5, 200.5, 576.75, 519.1500244140625, 924.4000244140625","60.25, 160.0500030517578, 205.14999389648438, 537.0, 513.4500122070312, 785.9000244140625"
POONAWALLA,6,5,1,6554,6.55,"65.94999694824219, 70.0, 67.19999694824219, 89.80000305175781, 117.80000305175781, 27.100000381469727","73.9000015258789, 75.0999984741211, 62.54999923706055, 95.4000015258789, 124.69999694824219, 25.75"
POWERGRID,2,1,1,-1403,-1.4,"46.77188491821289, 113.34378051757812","49.6406364440918, 105.97502899169922"
POWERINDIA,0,0,0,0,0.0,,
POWERMECH,4,1,3,-3227,-3.23,"919.7000122070312, 931.7000122070312, 738.1500244140625, 454.1499938964844","971.5999755859375, 894.0, 705.2000122070312, 421.6000061035156"
PPLPHARMA,1,1,0,4234,4.23,79.44322204589844,90.28305053710938
PRAJIND,3,1,2,15880,15.88,"64.4000015258789, 112.8499984741211, 63.20000076293945","108.94999694824219, 95.05000305175781, 59.849998474121094"
PRAKASH,6,4,2,26896,26.9,"55.37141418457031, 42.220703125, 25.868833541870117, 35.099998474121094, 56.25, 53.349998474121094","95.60221099853516, 49.83427429199219, 26.128387451171875, 32.849998474121094, 52.0, 54.650001525878906"
PRECWIRE,4,2,2,9641,9.64,"11.273332595825195, 2.0266659259796143, 21.860000610351562, 13.34666633605957","11.706665992736816, 3.2133328914642334, 16.85333251953125, 13.19333267211914"
PREMEXPLN,3,1,2,-332,-0.33,"365.3999938964844, 175.3000030517578, 104.4000015258789","348.3500061035156, 168.35000610351562, 109.55000305175781"
PRESTIGE,3,1,2,-2568,-2.57,"146.5500030517578, 104.69999694824219, 209.60000610351562","149.5500030517578, 100.19999694824219, 196.89999389648438"
PRICOLLTD,5,2,3,14208,14.21,"32.98120880126953, 7.111849784851074, 17.2017879486084, 32.71451187133789, 41.33763122558594","35.11476135253906, 10.667776107788086, 17.06844139099121, 31.781082153320312, 35.0703125"
PRINCEPIPE,2,0,2,-759,-0.76,"108.8499984741211, 639.1500244140625","112.75, 610.0499877929688"
PRIVISCL,3,3,0,5088,5.09,"160.49331665039062, 1245.3499755859375, 1051.5999755859375","172.46009826660156, 1393.050048828125, 1069.300048828125"
PRSMJOHNSN,3,0,3,-5700,-5.7,"18.399999618530273, 95.6500015258789, 46.54999923706055","17.100000381469727, 94.0999984741211, 44.400001525878906"
PRUDENT,0,0,0,0,0.0,,
PSB,3,0,3,-10972,-10.97,"32.70000076293945, 31.25, 13.899999618530273","25.899999618530273, 27.649999618530273, 13.300000190734863"
PSPPROJECT,1,1,0,790,0.79,389.95001220703125,400.3500061035156
PTC,8,4,4,-10769,-10.77,"57.04999923706055, 59.70000076293945, 64.75, 83.8499984741211, 58.349998474121094, 48.5, 92.25, 84.75","57.650001525878906, 61.400001525878906, 65.5, 66.69999694824219, 49.79999923706055, 51.75, 88.44999694824219, 76.75"
PTCIL,0,0,0,0,0.0,,
PURVA,3,1,2,15011,15.01,"69.55000305175781, 80.0, 64.3499984741211","109.75, 67.19999694824219, 65.3499984741211"
PVRINOX,0,0,0,0,0.0,,
QUESS,6,4,2,479,0.48,"746.75, 518.7999877929688, 365.75, 709.0499877929688, 645.25, 405.75","698.9000244140625, 520.0, 367.0, 704.0499877929688, 552.7999877929688, 449.8999938964844"
QUICKHEAL,3,3,0,12739,12.74,"225.60000610351562, 207.5500030517578, 159.39999389648438","313.79998779296875, 215.5500030517578, 158.9499969482422"
RADICO,7,4,3,5170,5.17,"171.39999389648438, 142.4499969482422, 71.1500015258789, 118.5, 120.69999694824219, 415.29998779296875, 940.75","168.60000610351562, 139.1999969482422, 70.80000305175781, 119.5999984741211, 134.14999389648438, 400.45001220703125, 1046.9000244140625"
RAILTEL,1,0,1,-2470,-2.47,108.4000015258789,97.19999694824219
RAIN,6,4,2,8754,8.75,"39.40999984741211, 16.170000076293945, 32.04999923706055, 37.099998474121094, 43.79999923706055, 95.80000305175781","49.15999984741211, 18.200000762939453, 33.58000183105469, 35.849998474121094, 38.45000076293945, 98.05000305175781"
RAINBOW,0,0,0,0,0.0,,
RAJESHEXPO,5,4,1,26362,26.36,"34.916664123535156, 26.950000762939453, 100.4000015258789, 498.25, 663.4000244140625","35.150001525878906, 44.70000076293945, 110.75, 529.2000122070312, 675.8499755859375"
RAJRATAN,1,0,1,-1778,-1.78,769.7999877929688,723.0
RALLIS,6,3,3,-801,-0.8,"27.516666412353516, 25.549999237060547, 209.3000030517578, 178.64999389648438, 212.5, 197.10000610351562","30.676666259765625, 24.97333335876465, 182.10000610351562, 160.35000610351562, 225.10000610351562, 218.75"
RAMCOCEM,5,4,1,3118,3.12,"71.44999694824219, 178.35000610351562, 603.5999755859375, 794.7000122070312, 733.8499755859375","80.4000015258789, 178.64999389648438, 635.0999755859375, 698.75, 757.0"
RAMCOIND,14,8,6,12431,12.43,"71.19750213623047, 44.26250076293945, 38.38249969482422, 22.850000381469727, 44.5, 41.400001525878906, 37.599998474121094, 114.9000015258789, 219.0, 213.0500030517578, 183.14999389648438, 157.60000610351562, 212.0, 154.1999969482422","69.74500274658203, 49.275001525878906, 31.662500381469727, 34.83250045776367, 42.04999923706055, 35.45000076293945, 37.70000076293945, 116.80000305175781, 222.10000610351562, 207.9499969482422, 183.10000610351562, 170.25, 187.8000030517578, 164.39999389648438"
RAMKY,3,1,2,-6970,-6.97,"44.79999923706055, 155.75, 195.14999389648438","39.04999923706055, 133.60000610351562, 208.25"
RATEGAIN,0,0,0,0,0.0,,
RATNAMANI,4,3,1,18920,18.92,"32.43333435058594, 324.73333740234375, 595.1333618164062, 696.1666870117188","49.83333206176758, 330.0, 628.7999877929688, 696.7000122070312"
RAYMOND,9,6,3,28603,28.6,"431.5, 107.75, 87.25, 228.3000030517578, 422.0, 809.5, 811.5, 277.54998779296875, 287.70001220703125","452.6000061035156, 91.6500015258789, 153.64999389648438, 268.45001220703125, 465.70001220703125, 844.75, 771.6500244140625, 239.10000610351562, 290.70001220703125"
RBA,3,3,0,6721,6.72,"145.64999389648438, 111.0, 102.19999694824219","158.9499969482422, 119.94999694824219, 108.19999694824219"
RBLBANK,4,0,4,-6381,-6.38,"530.5499877929688, 374.1499938964844, 173.5, 122.30000305175781","515.9000244140625, 344.8500061035156, 169.5500030517578, 113.75"
RCF,4,1,3,-9344,-9.34,"42.0, 66.30000305175781, 45.45000076293945, 53.849998474121094","41.849998474121094, 66.1500015258789, 43.099998474121094, 38.400001525878906"
RECLTD,6,3,3,-2250,-2.25,"86.13749694824219, 66.9000015258789, 79.57499694824219, 89.8499984741211, 95.25, 98.25","89.21249389648438, 60.037498474121094, 89.3812484741211, 73.42500305175781, 89.36250305175781, 108.75"
REDINGTON,1,1,0,23581,23.58,13.4350004196167,23.084999084472656
REDTAPE,0,0,0,0,0.0,,
RELAXO,3,1,2,4666,4.67,"32.5, 243.60000610351562, 850.9500122070312","40.0099983215332, 223.22500610351562, 843.25"
RELIANCE,3,1,2,-1022,-1.02,"597.6307373046875, 339.94891357421875, 425.5075988769531","549.399658203125, 350.3722839355469, 427.8162841796875"
RELIGARE,3,2,1,3400,3.4,"60.400001525878906, 29.399999618530273, 41.349998474121094","70.05000305175781, 31.950000762939453, 37.54999923706055"
RELINFRA,7,3,4,-10408,-10.41,"632.2999877929688, 433.6499938964844, 396.45001220703125, 528.6500244140625, 477.95001220703125, 22.25, 26.850000381469727","607.0999755859375, 508.6000061035156, 451.1499938964844, 509.25, 300.20001220703125, 16.75, 27.700000762939453"
RENUKA,11,5,6,-3864,-3.86,"23.372499465942383, 36.75, 67.8499984741211, 70.1500015258789, 38.04999923706055, 19.100000381469727, 11.449999809265137, 15.25, 18.149999618530273, 8.100000381469727, 11.149999618530273","21.950000762939453, 39.75, 63.349998474121094, 57.79999923706055, 37.79999923706055, 22.450000762939453, 13.100000381469727, 15.550000190734863, 17.100000381469727, 8.449999809265137, 8.75"
REPCOHOME,5,3,2,10118,10.12,"638.9500122070312, 660.3499755859375, 644.6500244140625, 146.3000030517578, 260.8999938964844","673.1500244140625, 658.5, 590.4000244140625, 177.14999389648438, 312.1499938964844"
RESPONIND,4,2,2,-2728,-2.73,"97.0, 83.44999694824219, 110.69999694824219, 149.0500030517578","90.1500015258789, 86.6500015258789, 107.5, 157.89999389648438"
RHIM,4,2,2,1921,1.92,"84.0, 238.60000610351562, 175.25, 650.25","83.44999694824219, 239.89999389648438, 170.85000610351562, 707.1500244140625"
RIIL,8,5,3,13880,13.88,"468.1499938964844, 1547.6500244140625, 724.25, 436.5, 386.6000061035156, 385.54998779296875, 337.0, 326.29998779296875","482.20001220703125, 1176.949951171875, 1120.300048828125, 493.70001220703125, 365.1000061035156, 401.29998779296875, 354.54998779296875, 319.3500061035156"
RITES,2,1,1,1822,1.82,"207.9600067138672, 263.04998779296875","196.27999877929688, 297.45001220703125"
RKFORGE,9,6,3,44910,44.91,"19.209999084472656, 7.239999771118164, 22.229999542236328, 81.18000030517578, 76.80000305175781, 104.95999908447266, 72.2699966430664, 46.97999954223633, 178.3000030517578","23.209999084472656, 12.539999961853027, 20.520000457763672, 76.9000015258789, 79.87000274658203, 101.20999908447266, 76.18000030517578, 66.47000122070312, 200.64999389648438"
ROLEXRINGS,0,0,0,0,0.0,,
ROSSARI,3,1,2,985,0.99,"984.5499877929688, 686.7999877929688, 799.1500244140625","970.0, 731.2999877929688, 796.4500122070312"
ROUTE,0,0,0,0,0.0,,
RPGLIFE,7,6,1,20927,20.93,"124.94999694824219, 66.55000305175781, 64.5999984741211, 60.099998474121094, 362.95001220703125, 247.85000610351562, 204.9499969482422","127.0, 69.0, 71.3499984741211, 70.5999984741211, 396.45001220703125, 234.6999969482422, 254.5"
RPOWER,7,2,5,-16844,-16.84,"95.5, 70.6500015258789, 50.45000076293945, 44.79999923706055, 45.349998474121094, 37.75, 2.299999952316284","85.44999694824219, 68.44999694824219, 52.5, 47.5, 40.45000076293945, 26.100000381469727, 1.899999976158142"
RPSGVENT,3,0,3,-8944,-8.94,"341.1000061035156, 178.60000610351562, 543.0499877929688","274.6000061035156, 167.5, 505.70001220703125"
RRKABEL,0,0,0,0,0.0,,
RSYSTEMS,3,0,3,-13794,-13.79,"12.649999618530273, 71.30000305175781, 44.54999923706055","9.329999923706055, 69.94999694824219, 37.150001525878906"
RTNINDIA,3,3,0,33405,33.4,"2.8499999046325684, 3.200000047683716, 3.75","3.6500000953674316, 3.9000000953674316, 5.849999904632568"
RTNPOWER,9,5,4,22320,22.32,"11.25, 8.149999618530273, 4.099999904632568, 3.75, 1.5, 1.899999976158142, 2.5, 2.3499999046325684, 7.400000095367432","16.700000762939453, 11.350000381469727, 3.25, 3.450000047683716, 1.5499999523162842, 1.899999976158142, 2.0999999046325684, 3.1500000953674316, 7.099999904632568"
RUPA,1,1,0,4358,4.36,286.04998779296875,326.70001220703125
RUSTOMJEE,0,0,0,0,0.0,,
RVNL,0,0,0,0,0.0,,
SAFARI,0,0,0,0,0.0,,
SAGCEM,5,2,3,13100,13.1,"30.020000457763672, 28.760000228881836, 129.42999267578125, 66.88999938964844, 205.75","25.270000457763672, 32.29999923706055, 125.83000183105469, 97.08999633789062, 198.9499969482422"
SAIL,7,4,3,1479,1.48,"156.10000610351562, 169.60000610351562, 101.6500015258789, 49.95000076293945, 53.75, 36.599998474121094, 81.30000305175781","127.69999694824219, 159.3000030517578, 103.1500015258789, 61.70000076293945, 55.79999923706055, 39.349998474121094, 76.75"
SAKSOFT,8,5,3,1108,1.11,"10.989999771118164, 17.5, 10.510000228881836, 3.5, 5.889999866485596, 4.090000152587891, 22.670000076293945, 17.7549991607666","8.699999809265137, 12.494999885559082, 12.0, 3.6600000858306885, 7.320000171661377, 4.28000020980835, 18.864999771118164, 18.774999618530273"
SALASAR,1,1,0,15810,15.81,1.0455000400543213,1.5820000171661377
SAMHI,0,0,0,0,0.0,,
SANDHAR,4,2,2,6726,6.73,"298.54998779296875, 195.5500030517578, 254.8000030517578, 269.5","281.75, 206.4499969482422, 242.39999389648438, 316.6000061035156"
SANDUMA,0,0,0,0,0.0,,
SANGAMIND,5,2,3,15795,15.8,"14.5, 33.70000076293945, 45.0, 76.30000305175781, 48.45000076293945","22.850000381469727, 33.150001525878906, 41.20000076293945, 71.44999694824219, 49.900001525878906"
SANGHIIND,6,4,2,26384,26.38,"24.5, 24.75, 60.5, 62.25, 25.0, 55.650001525878906","36.04999923706055, 27.5, 73.80000305175781, 61.25, 23.399999618530273, 57.0"
SANGHVIMOV,7,6,1,33552,33.55,"89.19999694824219, 106.69999694824219, 269.8999938964844, 169.9499969482422, 111.1500015258789, 98.69999694824219, 58.650001525878906","155.5, 107.55000305175781, 217.60000610351562, 182.1999969482422, 130.35000610351562, 106.0, 64.05000305175781"
SANOFI,4,1,3,-6465,-6.47,"1653.9000244140625, 1321.1500244140625, 1163.25, 5853.0498046875","1599.5999755859375, 1446.5999755859375, 903.4500122070312, 5498.64990234375"
SANSERA,1,0,1,-3369,-3.37,793.3499755859375,691.3499755859375
SAPPHIRE,2,1,1,3716,3.72,"1147.5999755859375, 1455.25","1341.5, 1374.1500244140625"
SARDAEN,5,1,4,-12301,-12.3,"27.364999771118164, 12.074999809265137, 11.145000457763672, 42.345001220703125, 96.30999755859375","22.905000686645508, 12.369999885559082, 10.255000114440918, 33.69499969482422, 104.19499969482422"
SAREGAMA,3,1,2,-2401,-2.4,"5.569605827331543, 6.813776016235352, 40.343196868896484","5.346044063568115, 6.30347204208374, 41.88868713378906"
SASKEN,5,3,2,-12841,-12.84,"331.1000061035156, 178.5500030517578, 58.099998474121094, 593.1500244140625, 481.0","145.39999389648438, 142.25, 69.30000305175781, 589.9000244140625, 542.7000122070312"
SATIN,5,2,3,-11353,-11.35,"390.02423095703125, 339.0700378417969, 233.1340789794922, 77.367919921875, 71.0","333.54376220703125, 265.8702697753906, 243.5778045654297, 70.48348236083984, 73.8499984741211"
SBCL,0,0,0,0,0.0,,
SBFC,0,0,0,0,0.0,,
SBGLP,0,0,0,0,0.0,,
SBICARD,1,0,1,-840,-0.84,939.25,922.2000122070312
SBILIFE,3,3,0,5386,5.39,"597.8499755859375, 806.4500122070312, 1235.0","595.0, 912.8499755859375, 1306.9000244140625"
SBIN,4,1,3,-114,-0.11,"191.77000427246094, 194.25, 269.54998779296875, 528.3499755859375","207.86000061035156, 189.0, 259.3500061035156, 531.25"
SCHAEFFLER,4,2,2,95,0.09,"137.60000610351562, 844.5, 713.4400024414062, 3203.0","129.25, 915.8099975585938, 721.47998046875, 3131.199951171875"
SCHNEIDER,2,1,1,1420,1.42,"112.30000305175781, 83.0999984741211","100.1500015258789, 93.75"
SCI,11,6,5,32778,32.78,"97.4000015258789, 162.06666564941406, 82.0, 111.30000305175781, 65.5999984741211, 37.5, 69.94999694824219, 74.55000305175781, 43.25, 47.150001525878906, 118.25","106.66666412353516, 187.3333282470703, 136.8000030517578, 104.3499984741211, 70.0, 34.54999923706055, 69.0, 64.4000015258789, 57.75, 57.099998474121094, 113.8499984741211"
SDBL,2,0,2,-2898,-2.9,"31.12811851501465, 27.1004695892334","31.069034576416016, 24.17574691772461"
SEAMECLTD,5,1,4,-6926,-6.93,"171.64999389648438, 59.849998474121094, 115.0, 369.54998779296875, 1096.300048828125","151.3000030517578, 58.95000076293945, 99.5999984741211, 402.95001220703125, 1088.300048828125"
SENCO,0,0,0,0,0.0,,
SEPC,3,0,3,-8707,-8.71,"119.62763214111328, 69.8238754272461, 4.931064128875732","125.29835510253906, 69.97180938720703, 3.5010550022125244"
SEQUENT,3,1,2,-10281,-10.28,"108.03478240966797, 72.3499984741211, 127.75","117.68150329589844, 50.5, 113.6500015258789"
SESHAPAPER,1,1,0,4942,4.94,174.5500030517578,202.39999389648438
SFL,3,1,2,-1644,-1.64,"644.625, 1490.9000244140625, 1211.1500244140625","619.9249877929688, 1436.300048828125, 1213.9000244140625"
SHAILY,1,1,0,4155,4.16,257.0799865722656,295.80999755859375
SHAKTIPUMP,4,1,3,-10063,-10.06,"50.25, 149.25, 243.9499969482422, 531.1500244140625","42.95000076293945, 152.9499969482422, 205.6999969482422, 470.29998779296875"
SHALBY,0,0,0,0,0.0,,
SHANTIGEAR,5,2,3,14121,14.12,"68.44999694824219, 34.5, 108.3499984741211, 90.5, 103.80000305175781","65.5, 49.0, 105.5999984741211, 100.0, 96.8499984741211"
SHARDACROP,4,2,2,-3686,-3.69,"402.95001220703125, 263.3500061035156, 514.9500122070312, 368.6000061035156","331.04998779296875, 294.79998779296875, 495.1000061035156, 384.5"
SHARDAMOTR,5,1,4,-8957,-8.96,"176.73342895507812, 420.47662353515625, 223.44863891601562, 181.82000732421875, 700.0","163.796142578125, 377.17694091796875, 215.42613220214844, 145.2899932861328, 778.6500244140625"
SHAREINDIA,1,1,0,2366,2.37,1201.4000244140625,1294.6500244140625
SHILPAMED,8,4,4,-9150,-9.15,"88.3499984741211, 64.91666412353516, 90.69999694824219, 677.0999755859375, 352.6000061035156, 303.20001220703125, 427.45001220703125, 456.29998779296875","83.76666259765625, 69.81666564941406, 95.46665954589844, 643.2000122070312, 214.5, 282.1000061035156, 517.75, 434.3999938964844"
SHK,1,0,1,-819,-0.82,115.05000305175781,111.0
SHOPERSTOP,8,3,5,16375,16.38,"52.071006774902344, 364.4970397949219, 310.24853515625, 511.43194580078125, 404.9230651855469, 392.09466552734375, 170.27218627929688, 663.0999755859375","84.54438018798828, 332.30767822265625, 345.7041320800781, 485.2544250488281, 354.31951904296875, 359.7633056640625, 163.83432006835938, 760.6500244140625"
SHREECEM,5,2,3,-3300,-3.3,"1237.8499755859375, 2070.050048828125, 20857.30078125, 25921.5, 22073.099609375","1279.25, 2010.0999755859375, 23051.05078125, 22116.30078125, 21033.099609375"
SHRIPISTON,2,1,1,991,0.99,"297.0, 362.4750061035156","279.0, 396.0249938964844"
SHRIRAMFIN,5,2,3,12907,12.91,"152.04779052734375, 215.77049255371094, 563.2247924804688, 930.2636108398438, 1202.050048828125","157.26058959960938, 280.8572692871094, 618.8603515625, 905.368896484375, 1176.199951171875"
SHYAMMETL,0,0,0,0,0.0,,
SIEMENS,4,2,2,2999,3.0,"268.1000061035156, 709.0499877929688, 595.5, 1099.699951171875","311.1000061035156, 687.0999755859375, 551.7000122070312, 1137.800048828125"
SIGACHI,0,0,0,0,0.0,,
SIGNATURE,0,0,0,0,0.0,,
SINDHUTRAD,0,0,0,0,0.0,,
SIS,1,1,0,1582,1.58,407.67498779296875,424.25
SIYSIL,6,0,6,-16642,-16.64,"52.07999801635742, 244.1699981689453, 209.75999450683594, 447.45001220703125, 135.10000610351562, 147.85000610351562","45.72999954223633, 218.97000122070312, 202.6300048828125, 357.8999938964844, 129.4499969482422, 140.75"
SJS,0,0,0,0,0.0,,
SJVN,3,1,2,-592,-0.59,"22.200000762939453, 20.450000762939453, 21.799999237060547","21.5, 20.0, 22.049999237060547"
SKFINDIA,5,2,3,-997,-1.0,"232.5, 150.0, 1264.199951171875, 2151.39990234375, 1669.1500244140625","200.0, 177.0, 1266.199951171875, 2185.25, 1470.0"
SKIPPER,2,1,1,991,0.99,"153.08998107910156, 152.30841064453125","164.12965393066406, 143.22265625"
SMLISUZU,8,4,4,5852,5.85,"134.8312530517578, 269.29998779296875, 966.75, 1187.949951171875, 1071.1500244140625, 888.0, 833.0, 692.5","176.22601318359375, 290.1499938964844, 987.25, 1271.5999755859375, 915.8499755859375, 790.4000244140625, 791.7999877929688, 621.3499755859375"
SOBHA,10,4,6,16798,16.8,"99.0999984741211, 293.5, 254.35000610351562, 312.79998779296875, 324.5, 293.54998779296875, 449.45001220703125, 226.89999389648438, 700.1500244140625, 520.6500244140625","192.10000610351562, 285.54998779296875, 235.25, 327.20001220703125, 309.3500061035156, 305.0, 297.0, 219.0500030517578, 698.7999877929688, 537.0"
SOLARINDS,4,2,2,-1497,-1.5,"56.0, 1088.5, 1267.199951171875, 1020.2000122070312","61.4900016784668, 1008.25, 1158.0, 1016.0"
SOMANYCERA,5,4,1,7130,7.13,"13.0, 595.2000122070312, 214.9499969482422, 118.30000305175781, 629.5","14.0, 620.9500122070312, 213.9499969482422, 129.0500030517578, 644.25"
SONACOMS,0,0,0,0,0.0,,
SONATSOFTW,4,2,2,1500,1.5,"16.143749237060547, 125.8125, 89.4749984741211, 293.0","15.618749618530273, 125.60624694824219, 98.9625015258789, 281.8500061035156"
SOTL,5,2,3,-3842,-3.84,"25.0, 127.86000061035156, 101.66000366210938, 225.3699951171875, 197.86000061035156","34.400001525878906, 109.01000213623047, 116.13999938964844, 201.3000030517578, 176.77000427246094"
SOUTHBANK,4,1,3,-4345,-4.34,"16.520097732543945, 16.100000381469727, 16.5, 8.050000190734863","17.244266510009766, 15.550000190734863, 15.550000190734863, 6.900000095367432"
SPANDANA,1,0,1,-389,-0.39,623.4000244140625,613.6500244140625
SPARC,8,4,4,-12858,-12.86,"84.9546890258789, 157.25656127929688, 51.588356018066406, 84.66157531738281, 191.10000610351562, 160.1999969482422, 161.89999389648438, 227.5","90.52388763427734, 87.93470001220703, 56.669029235839844, 87.88584899902344, 168.1999969482422, 159.9499969482422, 156.1999969482422, 229.9499969482422"
SPLPETRO,2,1,1,-450,-0.45,"10.800000190734863, 92.8499984741211","12.600000381469727, 75.3499984741211"
SRF,4,1,3,-8578,-8.58,"47.27000045776367, 343.05999755859375, 404.4800109863281, 2356.5","47.58000183105469, 311.2300109863281, 342.2200012207031, 2249.39990234375"
SSWL,3,2,1,16197,16.2,"12.109999656677246, 4.650000095367432, 43.5099983215332","14.09000015258789, 6.739999771118164, 41.20000076293945"
STAR,6,2,4,-5281,-5.28,"182.427978515625, 76.36520385742188, 485.7442321777344, 987.339599609375, 496.6000061035156, 340.5","154.68849182128906, 90.81771087646484, 469.8930969238281, 844.026611328125, 434.8999938964844, 359.29998779296875"
STARCEMENT,0,0,0,0,0.0,,
STARHEALTH,0,0,0,0,0.0,,
STLTECH,7,2,5,-8560,-8.56,"43.11000061035156, 58.54999923706055, 32.70000076293945, 157.39999389648438, 95.55000305175781, 224.4499969482422, 172.0500030517578","41.380001068115234, 61.400001525878906, 28.450000762939453, 130.85000610351562, 110.0999984741211, 193.14999389648438, 164.8000030517578"
STYLAMIND,1,0,1,-454,-0.45,1651.25,1585.5999755859375
STYRENIX,4,2,2,-4278,-4.28,"143.75, 743.25, 620.9500122070312, 818.0499877929688","151.1999969482422, 763.75, 593.5499877929688, 668.7000122070312"
SUBROS,7,3,4,8441,8.44,"31.350000381469727, 30.5, 19.799999237060547, 35.349998474121094, 33.400001525878906, 267.75, 175.25","31.450000762939453, 25.75, 27.850000381469727, 31.25, 31.100000381469727, 280.25, 170.3000030517578"
SUDARSCHEM,5,2,3,-8080,-8.08,"14.994999885559082, 66.55000305175781, 34.79999923706055, 39.0, 343.8999938964844","12.104999542236328, 54.099998474121094, 31.5, 41.0, 334.6499938964844"
SULA,0,0,0,0,0.0,,
SUMICHEM,1,1,0,5247,5.25,401.1000061035156,463.6499938964844
SUNCLAY,0,0,0,0,0.0,,
SUNDARMFIN,5,2,3,9455,9.45,"80.0303726196289, 215.59368896484375, 1123.980224609375, 1452.050048828125, 2011.75","124.36682891845703, 202.7013702392578, 1176.8162841796875, 1277.75, 1626.449951171875"
SUNDARMHLD,2,0,2,-5524,-5.52,"66.17101287841797, 43.19558334350586","60.1271858215332, 41.64018630981445"
SUNDRMFAST,9,9,0,30595,30.59,"66.9000015258789, 26.950000762939453, 20.0, 60.0, 54.20000076293945, 48.349998474121094, 474.5, 374.29998779296875, 1116.949951171875","69.0999984741211, 26.200000762939453, 31.0, 61.25, 55.45000076293945, 50.349998474121094, 489.25, 415.95001220703125, 1191.3499755859375"
SUNFLAG,5,2,3,-318,-0.32,"17.149999618530273, 27.200000762939453, 19.850000381469727, 69.5, 31.350000381469727","17.399999618530273, 29.75, 18.5, 56.79999923706055, 37.79999923706055"
SUNPHARMA,6,2,4,-2697,-2.7,"872.9500122070312, 829.9500122070312, 679.0, 552.9000244140625, 478.8500061035156, 426.75","853.9000244140625, 775.6500244140625, 688.1500244140625, 539.9500122070312, 457.6499938964844, 450.3999938964844"
SUNTECK,4,2,2,4258,4.26,"171.4499969482422, 119.0250015258789, 262.8500061035156, 363.1000061035156","170.60000610351562, 116.9749984741211, 274.25, 361.1000061035156"
SUNTV,6,2,4,-10308,-10.31,"361.29998779296875, 180.4499969482422, 401.75, 381.0, 472.20001220703125, 444.20001220703125","283.8999938964844, 164.3000030517578, 376.0, 407.45001220703125, 502.0, 439.25"
SUPRAJIT,6,1,5,-14221,-14.22,"13.050000190734863, 7.204999923706055, 19.850000381469727, 244.8000030517578, 144.4499969482422, 354.6499938964844","10.149999618530273, 6.804999828338623, 20.100000381469727, 232.35000610351562, 152.60000610351562, 338.5"
SUPREMEIND,4,2,2,5483,5.48,"18.74799919128418, 43.68000030517578, 32.09000015258789, 1174.75","19.665000915527344, 39.0, 44.130001068115234, 994.5"
SUPRIYA,1,0,1,-2295,-2.29,376.8500061035156,354.79998779296875
SURYAROSNI,5,1,4,-6202,-6.2,"27.774999618530273, 26.799999237060547, 126.1500015258789, 89.57499694824219, 58.875","29.950000762939453, 23.475000381469727, 119.57499694824219, 73.4000015258789, 56.775001525878906"
SURYODAY,2,0,2,-10019,-10.02,"135.5, 102.4000015258789","97.75, 97.9000015258789"
SUVEN,3,3,0,24032,24.03,"0.6596530079841614, 1.0080620050430298, 8.398969650268555","1.1218750476837158, 1.0103839635849, 8.717183113098145"
SUVENPHAR,2,1,1,-492,-0.49,"491.1000061035156, 464.8500061035156","450.95001220703125, 494.8999938964844"
SUZLON,11,8,3,26488,26.49,"198.98614501953125, 218.07582092285156, 263.7110595703125, 58.67387390136719, 82.96063232421875, 25.709991455078125, 8.81485366821289, 12.90090560913086, 14.599601745605469, 5.279729843139648, 7.529354095458984","221.01409912109375, 236.72474670410156, 254.71255493164062, 89.89315032958984, 70.9320297241211, 24.42449188232422, 9.04440689086914, 13.4977445602417, 15.976922988891602, 5.64701509475708, 7.988461017608643"
SWANENERGY,4,2,2,-1643,-1.64,"67.1500015258789, 117.44999694824219, 108.0999984741211, 239.14999389648438","63.0, 107.5, 111.4000015258789, 260.3500061035156"
SWARAJENG,5,3,2,32292,32.29,"107.19999694824219, 432.75, 1236.25, 1113.550048828125, 1514.800048828125","188.14999389648438, 425.25, 1221.4000244140625, 1447.6500244140625, 1588.3499755859375"
SWSOLAR,2,0,2,-4593,-4.59,"219.64999389648438, 381.54998779296875","223.75, 328.5"
SYMPHONY,5,2,3,114,0.11,"1166.6500244140625, 1215.800048828125, 1027.699951171875, 1070.949951171875, 900.5499877929688","1161.25, 1270.5, 1004.0999755859375, 1034.949951171875, 904.9000244140625"
SYNGENE,0,0,0,0,0.0,,
SYRMA,0,0,0,0,0.0,,
TAJGVK,6,4,2,26149,26.15,"213.14999389648438, 150.0, 56.0, 66.4000015258789, 81.75, 136.4499969482422","223.64999389648438, 140.5, 93.30000305175781, 62.150001525878906, 96.25, 138.35000610351562"
TANLA,3,1,2,15317,15.32,"45.70000076293945, 8.350000381469727, 3.5999999046325684","79.69999694824219, 6.849999904632568, 3.5"
TARC,0,0,0,0,0.0,,
TARSONS,0,0,0,0,0.0,,
TASTYBITE,2,2,0,9603,9.6,"11752.2001953125, 9253.099609375","12767.400390625, 11759.25"
TATACHEM,7,5,2,2031,2.03,"99.09165954589844, 145.67245483398438, 75.63592529296875, 118.11637878417969, 180.08448791503906, 307.5038146972656, 1104.0999755859375","106.32238006591797, 99.75300598144531, 95.38812255859375, 122.52535247802734, 184.66983032226562, 311.58209228515625, 1028.050048828125"
TATACOMM,6,5,1,21394,21.39,"168.1085968017578, 116.97750854492188, 266.3659973144531, 425.5025939941406, 334.0751037597656, 1045.9000244140625","206.75961303710938, 163.82440185546875, 267.9803161621094, 424.9748229980469, 325.5377197265625, 1202.25"
TATACONSUM,8,5,3,4209,4.21,"83.30000305175781, 80.58499908447266, 60.005001068115234, 147.25, 150.0500030517578, 133.4499969482422, 128.85000610351562, 763.8499755859375","79.91999816894531, 82.09500122070312, 60.59000015258789, 145.89999389648438, 149.4499969482422, 137.5500030517578, 138.0500030517578, 798.6500244140625"
TATAELXSI,7,5,2,13130,13.13,"108.8499984741211, 138.8249969482422, 54.900001525878906, 702.5999755859375, 963.0999755859375, 677.25, 6643.60009765625","110.2750015258789, 99.80000305175781, 75.875, 711.6749877929688, 930.4000244140625, 818.9500122070312, 7421.5498046875"
TATAINVEST,3,2,1,4564,4.56,"230.75, 850.5999755859375, 771.2999877929688","263.75, 891.5999755859375, 732.25"
TATAMOTORS,9,4,5,4687,4.69,"148.8778076171875, 35.67732620239258, 196.34400939941406, 384.95001220703125, 386.6000061035156, 523.5499877929688, 181.1999969482422, 98.25, 439.3999938964844","145.2272491455078, 48.242549896240234, 170.96621704101562, 423.5, 408.3500061035156, 456.75, 177.4499969482422, 104.6500015258789, 387.95001220703125"
TATAMTRDVR,5,1,4,-8920,-8.92,"107.3499984741211, 260.1000061035156, 332.95001220703125, 81.75, 40.04999923706055","95.3499984741211, 298.79998779296875, 276.0, 71.3499984741211, 37.5"
TATAPOWER,7,3,4,-4999,-5.0,"68.8499984741211, 64.6500015258789, 76.69999694824219, 62.5, 58.099998474121094, 44.849998474121094, 213.5500030517578","67.19999694824219, 70.5, 65.8499984741211, 59.29999923706055, 46.70000076293945, 48.70000076293945, 221.85000610351562"
TATASTEEL,8,6,2,17217,17.22,"40.90359878540039, 19.616846084594727, 51.161956787109375, 34.33186340332031, 23.49448585510254, 52.099998474121094, 42.75, 32.66999816894531","47.059898376464844, 22.68465805053711, 49.79954528808594, 31.29739761352539, 21.817668914794922, 55.720001220703125, 47.20500183105469, 36.630001068115234"
TATATECH,0,0,0,0,0.0,,
TATVA,1,0,1,-4943,-4.94,1601.800048828125,1339.5999755859375
TCI,3,2,1,2662,2.66,"140.2967987060547, 210.0500030517578, 709.0999755859375","132.1744842529297, 233.4499969482422, 716.4000244140625"
TCIEXP,1,0,1,-130,-0.13,1587.25,1571.699951171875
TCNSBRANDS,2,0,2,-5709,-5.71,"425.25, 436.6000061035156","396.20001220703125, 378.5"
TCPLPACK,0,0,0,0,0.0,,
TCS,4,2,2,-1013,-1.01,"269.3500061035156, 134.6374969482422, 557.9000244140625, 3390.800048828125","218.4375, 155.52499389648438, 557.7750244140625, 3256.699951171875"
TDPOWERSYS,2,0,2,-6770,-6.77,"47.709999084472656, 23.579999923706055","43.70000076293945, 19.93000030517578"
TEAMLEASE,4,1,3,-1452,-1.45,"3024.949951171875, 2585.25, 1680.5, 3500.25","2945.64990234375, 2321.949951171875, 1849.800048828125, 3386.0"
TECHM,6,4,2,15190,15.19,"228.39999389648438, 81.9749984741211, 485.20001220703125, 428.1499938964844, 714.5, 1076.0999755859375","216.1125030517578, 118.4124984741211, 488.8999938964844, 457.8500061035156, 739.0, 1008.5999755859375"
TECHNOE,4,2,2,20463,20.46,"77.30000305175781, 45.150001525878906, 264.29998779296875, 203.8000030517578","116.0, 57.474998474121094, 240.89999389648438, 201.5500030517578"
TEGA,0,0,0,0,0.0,,
TEJASNET,2,1,1,3309,3.31,"99.30000305175781, 47.900001525878906","95.05000305175781, 57.70000076293945"
TEXRAIL,11,6,5,16145,16.15,"73.95500183105469, 74.0, 58.150001525878906, 63.605201721191406, 64.24079895019531, 53.48103332519531, 117.49483489990234, 95.38510131835938, 90.39112091064453, 84.85233306884766, 68.68998718261719","90.04000091552734, 49.79999923706055, 91.0, 67.23719024658203, 54.8430290222168, 55.569427490234375, 130.66079711914062, 104.23807525634766, 80.49394989013672, 81.2657470703125, 69.64338684082031"
THANGAMAYL,4,3,1,9790,9.79,"97.625, 129.625, 526.125, 547.2249755859375","103.2249984741211, 160.0500030517578, 564.7000122070312, 530.7750244140625"
THEJO,2,2,0,12197,12.2,"161.6666717529297, 155.93333435058594","193.93333435058594, 191.6666717529297"
THERMAX,10,5,5,4636,4.64,"491.29998779296875, 180.64999389648438, 647.1500244140625, 480.0, 904.4500122070312, 825.8499755859375, 1041.25, 1020.0, 754.9500122070312, 2153.0","417.0, 225.0, 604.75, 483.45001220703125, 838.5, 880.2999877929688, 1120.25, 1058.300048828125, 744.9000244140625, 2292.699951171875"
THOMASCOOK,4,3,1,19793,19.79,"20.03278160095215, 14.905667304992676, 20.497562408447266, 57.534786224365234","18.5258731842041, 22.113401412963867, 20.67911720275879, 63.79999923706055"
THYROCARE,3,1,2,-679,-0.68,"668.9500122070312, 700.2999877929688, 517.9500122070312","611.2000122070312, 641.2000122070312, 593.9000244140625"
TI,1,0,1,-9009,-9.01,51.20000076293945,36.45000076293945
TIDEWATER,3,1,2,-3361,-3.36,"970.0399780273438, 814.52001953125, 1139.25","939.5800170898438, 845.7999877929688, 1026.25"
TIIL,10,5,5,9102,9.1,"31.399999618530273, 23.649999618530273, 60.650001525878906, 33.0, 211.64999389648438, 369.0, 339.0, 248.0500030517578, 886.0499877929688, 2281.64990234375","23.149999618530273, 36.95000076293945, 55.20000076293945, 34.70000076293945, 230.0, 353.1499938964844, 287.45001220703125, 221.64999389648438, 907.5, 2468.949951171875"
TIINDIA,1,1,0,4030,4.03,444.3999938964844,508.8999938964844
TIMETECHNO,3,2,1,-116,-0.12,"50.900001525878906, 102.5999984741211, 37.45000076293945","55.75, 90.55000305175781, 36.599998474121094"
TIMKEN,5,3,2,7871,7.87,"160.0, 514.0999755859375, 581.0, 3251.949951171875, 3340.449951171875","158.75, 547.7999877929688, 565.2000122070312, 3387.699951171875, 3953.5"
TIPSINDLTD,4,2,2,774,0.77,"5.326353073120117, 2.707916021347046, 4.803606986999512, 5.5382771492004395","4.4504008293151855, 3.470841884613037, 5.180360794067383, 4.205511093139648"
TIRUMALCHM,6,4,2,31729,31.73,"14.0600004196167, 5.349999904632568, 11.050000190734863, 88.30000305175781, 70.19999694824219, 48.900001525878906","16.71500015258789, 8.880000114440918, 10.710000038146973, 86.19999694824219, 81.30000305175781, 52.900001525878906"
TITAGARH,8,4,4,16094,16.09,"38.38999938964844, 73.18000030517578, 75.25, 23.1200008392334, 102.0, 81.44999694824219, 69.94999694824219, 50.54999923706055","63.119998931884766, 81.76000213623047, 78.87000274658203, 22.040000915527344, 120.9000015258789, 68.55000305175781, 62.20000076293945, 41.849998474121094"
TITAN,6,4,2,10766,10.77,"39.17499923706055, 62.11750030517578, 349.95001220703125, 362.04998779296875, 927.0999755859375, 1273.050048828125","40.337501525878906, 58.96500015258789, 381.5, 437.20001220703125, 931.0, 1331.199951171875"
TMB,1,1,0,2448,2.45,437.8500061035156,445.29998779296875
TORNTPHARM,3,1,2,-1638,-1.64,"659.0250244140625, 835.4249877929688, 1395.9749755859375","601.75, 853.7999877929688, 1407.175048828125"
TORNTPOWER,8,3,5,21463,21.46,"110.80000305175781, 250.8000030517578, 175.85000610351562, 84.19999694824219, 104.30000305175781, 154.5500030517578, 188.4499969482422, 533.1500244140625","93.55000305175781, 247.1999969482422, 153.6999969482422, 124.9000015258789, 157.10000610351562, 178.14999389648438, 180.3000030517578, 456.04998779296875"
TRENT,5,4,1,6462,6.46,"66.42914581298828, 59.7725830078125, 94.71499633789062, 104.29499816894531, 615.2999877929688","70.32217407226562, 60.3621826171875, 95.19499969482422, 126.47000122070312, 558.0999755859375"
TRIDENT,4,2,2,17102,17.1,"2.575000047683716, 0.9150000214576721, 5.914999961853027, 6.949999809265137","2.375, 1.465000033378601, 6.179999828338623, 6.699999809265137"
TRIL,6,1,5,3914,3.91,"15.309000968933105, 24.57450294494629, 16.641000747680664, 11.493000984191895, 27.155000686645508, 13.25","27.522001266479492, 22.014001846313477, 14.431501388549805, 8.248499870300293, 25.774999618530273, 11.449999809265137"
TRITURBINE,2,1,1,22,0.02,"110.0, 98.0","115.30000305175781, 95.0999984741211"
TRIVENI,5,3,2,18449,18.45,"29.633407592773438, 27.65418243408203, 28.698774337768555, 20.450000762939453, 54.5","26.444656372070312, 28.973665237426758, 47.91375732421875, 18.649999618530273, 54.20000076293945"
TTKHLTCARE,3,0,3,-4895,-4.89,"356.1000061035156, 1041.25, 518.5499877929688","349.54998779296875, 951.5999755859375, 480.1499938964844"
TTKPRESTIG,5,4,1,19606,19.61,"9.245833396911621, 11.212499618530273, 8.754165649414062, 271.79998779296875, 541.4400024414062","10.345832824707031, 10.795832633972168, 10.787500381469727, 293.7291564941406, 578.3350219726562"
TTML,3,0,3,-11860,-11.86,"15.619257926940918, 11.94662094116211, 7.224236965179443","13.128619194030762, 10.849052429199219, 6.219542026519775"
TV18BRDCST,6,3,3,4796,4.8,"75.48788452148438, 39.245121002197266, 35.5, 23.899999618530273, 40.900001525878906, 35.099998474121094","104.99678039550781, 32.08235168457031, 31.299999237060547, 24.600000381469727, 37.79999923706055, 37.349998474121094"
TVSHLTD,3,3,0,11704,11.7,"514.6500244140625, 32.72095489501953, 3668.74658203125","601.5750122070312, 34.76335144042969, 3969.66015625"
TVSMOTOR,8,6,2,28023,28.02,"62.224998474121094, 11.350000381469727, 59.849998474121094, 37.900001525878906, 36.849998474121094, 422.0, 335.8999938964844, 662.5499877929688","54.474998474121094, 16.524999618530273, 56.349998474121094, 38.70000076293945, 50.75, 486.6499938964844, 378.3500061035156, 686.5"
TVSSCS,0,0,0,0,0.0,,
TVSSRICHAK,2,1,1,4676,4.68,"3320.800048828125, 1407.199951171875","3922.64990234375, 1357.949951171875"
UBL,7,1,6,-5955,-5.96,"91.55000305175781, 827.3499755859375, 812.1500244140625, 1037.75, 1585.9000244140625, 1479.5, 1511.949951171875","88.69999694824219, 762.1500244140625, 813.25, 951.6500244140625, 1542.4000244140625, 1454.699951171875, 1540.25"
UCOBANK,10,5,5,15988,15.99,"18.899999618530273, 38.25, 28.299999237060547, 69.6500015258789, 72.94999694824219, 51.0, 38.79999923706055, 37.099998474121094, 20.850000381469727, 17.75","22.700000762939453, 34.20000076293945, 43.79999923706055, 75.75, 76.19999694824219, 48.45000076293945, 39.75, 36.150001525878906, 16.799999237060547, 16.700000762939453"
UFLEX,4,1,3,-4303,-4.3,"70.8499984741211, 202.39999389648438, 300.6000061035156, 211.0500030517578","70.75, 188.8000030517578, 289.20001220703125, 210.75"
UGROCAP,0,0,0,0,0.0,,
UJJIVANSFB,2,1,1,-2394,-2.39,"29.850000381469727, 22.25","34.400001525878906, 18.200000762939453"
ULTRACEMCO,5,4,1,12024,12.02,"902.5, 1839.199951171875, 4193.7998046875, 3904.85009765625, 6544.7998046875","1062.5999755859375, 2186.949951171875, 4475.5, 3893.550048828125, 6677.85009765625"
UNICHEMLAB,3,1,2,-6061,-6.06,"87.83999633789062, 248.75, 379.45001220703125","65.16000366210938, 266.29998779296875, 373.25"
UNIONBANK,9,3,6,-12247,-12.25,"116.9000015258789, 207.85000610351562, 137.39999389648438, 173.39999389648438, 176.4499969482422, 89.75, 63.04999923706055, 31.799999237060547, 28.0","136.4499969482422, 195.64999389648438, 151.14999389648438, 147.64999389648438, 164.10000610351562, 65.75, 54.79999923706055, 29.0, 31.549999237060547"
UNIPARTS,0,0,0,0,0.0,,
UNITECH,10,5,5,3001,3.0,"166.5, 34.900001525878906, 29.950000762939453, 26.049999237060547, 14.0, 21.649999618530273, 7.599999904632568, 1.25, 1.899999976158142, 1.850000023841858","196.0, 45.04999923706055, 23.0, 32.349998474121094, 15.850000381469727, 16.149999618530273, 7.099999904632568, 1.0, 1.7000000476837158, 1.899999976158142"
UNIVCABLES,5,2,3,-1147,-1.15,"35.099998474121094, 26.5, 118.0999984741211, 160.39999389648438, 584.0999755859375","40.04999923706055, 26.149999618530273, 107.55000305175781, 144.64999389648438, 611.8499755859375"
UNOMINDA,2,1,1,13518,13.52,"3.769368886947632, 8.96987247467041","5.497342109680176, 8.435892105102539"
UPL,9,3,6,8740,8.74,"76.63333129882812, 99.63333129882812, 476.8666687011719, 505.20001220703125, 603.9500122070312, 425.20001220703125, 740.2999877929688, 587.25, 507.1499938964844","109.26666259765625, 100.86666870117188, 442.8666687011719, 505.5, 596.4500122070312, 478.1499938964844, 685.0999755859375, 537.7000122070312, 508.79998779296875"
USHAMART,5,3,2,10798,10.8,"27.399999618530273, 31.450000762939453, 16.25, 11.5, 19.75","34.95000076293945, 35.75, 13.350000381469727, 14.550000190734863, 18.399999618530273"
UTIAMC,2,0,2,-9607,-9.61,"994.5999755859375, 825.0999755859375","791.9000244140625, 722.75"
UTKARSHBNK,0,0,0,0,0.0,,
V2RETAIL,4,2,2,27585,27.59,"37.25, 287.6499938964844, 158.60000610351562, 84.6500015258789","74.9000015258789, 254.39999389648438, 120.69999694824219, 101.5999984741211"
VADILALIND,2,2,0,2141,2.14,"532.0, 2682.85009765625","535.75, 2860.39990234375"
VAIBHAVGBL,10,3,7,8828,8.83,"57.38999938964844, 44.150001525878906, 3.5999999046325684, 6.599999904632568, 165.08999633789062, 96.86000061035156, 61.45000076293945, 61.029998779296875, 468.0, 324.3999938964844","54.599998474121094, 40.79999923706055, 5.28000020980835, 6.550000190734863, 161.25, 112.5999984741211, 60.81999969482422, 82.7699966430664, 335.75, 272.8500061035156"
VAKRANGEE,5,3,2,31347,31.35,"4.12434720993042, 0.7873640060424805, 31.02869987487793, 33.078643798828125, 32.65933609008789","3.907705068588257, 1.296355962753296, 40.02050018310547, 38.529632568359375, 26.323144912719727"
VARROC,1,1,0,2583,2.58,181.85000610351562,196.5500030517578
VBL,0,0,0,0,0.0,,
VEDL,10,4,6,-3958,-3.96,"59.415000915527344, 313.8999938964844, 217.9499969482422, 163.89999389648438, 89.8499984741211, 184.4499969482422, 174.35000610351562, 154.14999389648438, 92.19999694824219, 270.25","63.20750045776367, 289.8999938964844, 214.39999389648438, 142.8000030517578, 103.80000305175781, 166.85000610351562, 154.10000610351562, 148.35000610351562, 106.4000015258789, 270.04998779296875"
VENKEYS,6,3,3,10317,10.32,"102.30000305175781, 341.6666564941406, 223.03334045410156, 2770.89990234375, 1598.949951171875, 1640.300048828125","98.96666717529297, 285.9666748046875, 368.1000061035156, 2185.10009765625, 1747.449951171875, 1696.550048828125"
VENUSPIPES,0,0,0,0,0.0,,
VESUVIUS,3,1,2,2883,2.88,"247.0, 184.8000030517578, 98.25","227.75, 155.0500030517578, 121.25"
VGUARD,2,2,0,2584,2.58,"33.349998474121094, 210.60000610351562","33.94285583496094, 228.14999389648438"
VIDHIING,0,0,0,0,0.0,,
VIJAYA,0,0,0,0,0.0,,
VINATIORGA,3,0,3,-6313,-6.31,"37.900001525878906, 234.14999389648438, 1979.75","37.54999923706055, 207.1999969482422, 1819.300048828125"
VINDHYATEL,8,2,6,-11566,-11.57,"134.4499969482422, 142.10000610351562, 693.5, 1214.0999755859375, 1516.4000244140625, 1042.050048828125, 740.0999755859375, 1063.4000244140625","126.0, 166.0, 581.0499877929688, 1084.050048828125, 1293.949951171875, 908.4500122070312, 649.0499877929688, 1322.8499755859375"
VIPIND,8,3,5,11667,11.67,"21.3700008392334, 7.800000190734863, 92.44999694824219, 84.30000305175781, 98.0999984741211, 129.85000610351562, 463.54998779296875, 257.6499938964844","20.579999923706055, 11.850000381469727, 82.4000015258789, 81.25, 95.69999694824219, 152.25, 409.8500061035156, 270.6000061035156"
VISHNU,2,1,1,-1461,-1.46,"57.97999954223633, 303.0","50.130001068115234, 324.5"
VMART,7,5,2,17400,17.4,"176.10000610351562, 540.5, 2103.35009765625, 1990.699951171875, 2918.14990234375, 2211.85009765625, 2004.699951171875","191.0500030517578, 718.5499877929688, 1974.25, 2230.550048828125, 2810.10009765625, 2279.64990234375, 2178.550048828125"
VOLTAMP,3,1,2,-2726,-2.73,"395.45001220703125, 1120.0, 1091.5999755859375","399.54998779296875, 1090.3499755859375, 1031.699951171875"
VOLTAS,9,7,2,329801,329.8,"9.416000366210938, 60.0, 96.4000015258789, 283.45001220703125, 567.9500122070312, 553.9500122070312, 546.4500122070312, 892.0, 869.9000244140625","103.6500015258789, 98.4000015258789, 109.8499984741211, 289.1000061035156, 614.7999877929688, 553.5, 598.4000244140625, 818.25, 863.2999877929688"
VPRPL,0,0,0,0,0.0,,
VRLLOG,4,1,3,-6595,-6.6,"361.0, 286.6499938964844, 302.75, 164.6999969482422","292.1499938964844, 292.75, 293.04998779296875, 165.39999389648438"
VSSL,4,1,3,-3311,-3.31,"5.8994598388671875, 6.008708953857422, 66.0, 31.174999237060547","5.280379772186279, 7.064785003662109, 55.54999923706055, 28.350000381469727"
VSTIND,3,3,0,6141,6.14,"1628.25, 3149.300048828125, 3406.75","1815.3499755859375, 3271.199951171875, 3700.89990234375"
VSTTILLERS,3,2,1,3611,3.61,"1167.6500244140625, 1325.5999755859375, 2386.64990234375","1316.6500244140625, 1348.6500244140625, 2202.25"
VTL,5,3,2,26083,26.08,"13.180000305175781, 41.130001068115234, 39.25, 169.3699951171875, 302.6499938964844","26.010000228881836, 34.61000061035156, 39.65999984741211, 160.16000366210938, 332.3999938964844"
WABAG,6,4,2,2889,2.89,"182.0749969482422, 698.0, 574.8499755859375, 603.7000122070312, 298.5, 215.0500030517578","212.60000610351562, 687.75, 577.7000122070312, 610.6500244140625, 307.70001220703125, 188.25"
WEBELSOLAR,7,4,3,7965,7.97,"174.02499389648438, 57.025001525878906, 26.25, 6.300000190734863, 10.199999809265137, 22.200000762939453, 87.55000305175781","135.47500610351562, 69.7750015258789, 22.5, 7.800000190734863, 12.199999809265137, 20.25, 90.05000305175781"
WELCORP,9,5,4,30700,30.7,"73.69999694824219, 98.6500015258789, 190.85000610351562, 115.69999694824219, 87.05000305175781, 80.9000015258789, 136.1999969482422, 133.5500030517578, 79.75","71.55000305175781, 169.0, 207.4499969482422, 146.60000610351562, 81.4000015258789, 75.25, 132.9499969482422, 147.75, 87.80000305175781"
WELENT,8,3,5,19243,19.24,"72.05000305175781, 42.29999923706055, 37.150001525878906, 24.0, 14.550000190734863, 13.399999618530273, 31.850000381469727, 106.44999694824219","67.94999694824219, 83.5999984741211, 36.5, 23.100000381469727, 13.199999809265137, 11.350000381469727, 27.100000381469727, 112.3499984741211"
WELSPUNLIV,10,4,6,-15721,-15.72,"6.715000152587891, 2.134999990463257, 5.789999961853027, 4.204999923706055, 69.6500015258789, 62.70000076293945, 75.25, 52.650001525878906, 31.149999618530273, 77.0","6.644999980926514, 2.134999990463257, 4.760000228881836, 3.684999942779541, 66.8499984741211, 54.150001525878906, 58.54999923706055, 55.849998474121094, 37.099998474121094, 73.6500015258789"
WENDT,2,2,0,7821,7.82,"1866.300048828125, 2480.60009765625","1904.550048828125, 3124.050048828125"
WESTLIFE,0,0,0,0,0.0,,
WHEELS,3,2,1,20221,20.22,"33.8032341003418, 921.25, 609.7000122070312","45.689781188964844, 863.4500122070312, 813.2999877929688"
WHIRLPOOL,4,3,1,908,0.91,"265.6000061035156, 1509.699951171875, 1426.699951171875, 1506.75","280.6000061035156, 1373.550048828125, 1474.1500244140625, 1498.1500244140625"
WIPRO,10,6,4,14808,14.81,"121.11750793457031, 114.10875701904297, 55.3275032043457, 137.47503662109375, 142.89378356933594, 164.2500457763672, 177.91879272460938, 207.300048828125, 212.8000030517578, 591.9000244140625","134.97750854492188, 103.64625549316406, 74.44125366210938, 141.4500274658203, 131.4937744140625, 181.3500518798828, 171.7500457763672, 225.93756103515625, 219.64999389648438, 508.79998779296875"
WOCKPHARMA,11,5,6,8283,8.28,"384.2200622558594, 183.95181274414062, 82.41188049316406, 482.57965087890625, 421.92303466796875, 929.7609252929688, 693.4950561523438, 612.0050048828125, 325.5453796386719, 240.9499969482422, 235.4499969482422","388.7370300292969, 142.74586486816406, 111.40353393554688, 409.8009338378906, 707.414794921875, 753.7368774414062, 663.0285034179688, 499.44921875, 283.3254089355469, 244.0, 238.60000610351562"
WONDERLA,3,2,1,2291,2.29,"373.3500061035156, 276.45001220703125, 131.85000610351562","372.3999938964844, 281.20001220703125, 136.64999389648438"
WSTCSTPAPR,6,4,2,1693,1.69,"17.753999710083008, 85.55000305175781, 47.849998474121094, 228.64999389648438, 188.6999969482422, 586.9500122070312","16.790000915527344, 93.0999984741211, 47.54999923706055, 205.89999389648438, 171.1999969482422, 703.2999877929688"
XPROINDIA,1,0,1,-2426,-2.43,16.899999618530273,15.899999618530273
YASHO,0,0,0,0,0.0,,
YATHARTH,0,0,0,0,0.0,,
YATRA,0,0,0,0,0.0,,
YESBANK,7,6,1,33361,33.36,"17.889999389648438, 22.889999389648438, 15.4399995803833, 82.79000091552734, 354.3999938964844, 194.10000610351562, 14.699999809265137","18.489999771118164, 25.280000686645508, 25.1299991607666, 88.1500015258789, 322.29998779296875, 231.14999389648438, 17.850000381469727"
ZAGGLE,0,0,0,0,0.0,,
ZEEL,7,5,2,17856,17.86,"53.71631622314453, 123.5999984741211, 367.8999938964844, 489.1499938964844, 488.6000061035156, 293.04998779296875, 183.5500030517578","78.88704681396484, 134.75, 398.79998779296875, 509.45001220703125, 476.45001220703125, 292.20001220703125, 171.10000610351562"
ZENSARTECH,5,3,2,10935,10.93,"19.065000534057617, 15.805000305175781, 7.739999771118164, 28.5, 123.8499984741211","14.515000343322754, 14.125, 9.720000267028809, 34.72999954223633, 159.9499969482422"
ZENTEC,3,1,2,-1309,-1.31,"63.599998474121094, 90.9000015258789, 209.60000610351562","64.19999694824219, 94.3499984741211, 194.25"
ZFCVINDIA,5,2,3,10292,10.29,"1029.300048828125, 127.0, 1039.25, 6286.25, 7794.60009765625","1203.1500244140625, 151.14999389648438, 1025.75, 6205.4501953125, 7607.75"
ZOMATO,0,0,0,0,0.0,,
ZYDUSLIFE,5,1,4,-6605,-6.61,"35.625709533691406, 157.0500030517578, 412.3500061035156, 347.04998779296875, 378.3500061035156","36.700782775878906, 154.8699951171875, 361.29998779296875, 325.45001220703125, 357.0"
ZYDUSWELL,4,0,4,-5277,-5.28,"1360.449951171875, 1500.1500244140625, 1708.949951171875, 1550.300048828125","1273.5999755859375, 1466.699951171875, 1540.5999755859375, 1552.800048828125"
